vemquartile,administered_date,total_doses,cumulative_total_doses,pfizer_doses,cumulative_pfizer_doses,moderna_doses,cumulative_moderna_doses,jj_doses,cumulative_jj_doses,partially_vaccinated,total_partially_vaccinated,pct_age12pop_partially_vaccinated,fully_vaccinated,cumulative_fully_vaccinated,pct_age12pop_fully_vaccinated,at_least_one_dose,cumulative_at_least_one_dose,pct_age12pop_at_least_one_dose,age12_population
1,2020-07-27,1,1,1,1,0,0,0,0,1,1,0.0,0,0,0.0,1,1,0.0,8700223
1,2020-07-28,2,3,2,3,0,0,0,0,2,3,0.0,0,0,0.0,2,3,0.0,8700223
1,2020-07-30,7,10,4,7,3,3,0,0,6,9,1e-06,1,1,0.0,7,10,1e-06,8700223
1,2020-07-31,1,11,1,8,0,3,0,0,1,10,1e-06,0,1,0.0,1,11,1e-06,8700223
1,2020-08-01,1,12,0,8,1,4,0,0,1,11,1e-06,0,1,0.0,1,12,1e-06,8700223
1,2020-08-03,2,14,0,8,2,6,0,0,2,13,1e-06,0,1,0.0,2,14,2e-06,8700223
1,2020-08-04,3,17,2,10,1,7,0,0,3,16,2e-06,0,1,0.0,3,17,2e-06,8700223
1,2020-08-05,1,18,0,10,1,8,0,0,1,17,2e-06,0,1,0.0,1,18,2e-06,8700223
1,2020-08-06,2,20,0,10,2,10,0,0,2,19,2e-06,0,1,0.0,2,20,2e-06,8700223
1,2020-08-07,1,21,1,11,0,10,0,0,1,20,2e-06,0,1,0.0,1,21,2e-06,8700223
1,2020-08-09,1,22,0,11,1,11,0,0,1,21,2e-06,0,1,0.0,1,22,3e-06,8700223
1,2020-08-10,3,25,3,14,0,11,0,0,3,24,3e-06,0,1,0.0,3,25,3e-06,8700223
1,2020-08-11,3,28,0,14,3,14,0,0,3,27,3e-06,0,1,0.0,3,28,3e-06,8700223
1,2020-08-12,3,31,3,17,0,14,0,0,3,30,3e-06,0,1,0.0,3,31,4e-06,8700223
1,2020-08-13,4,35,2,19,2,16,0,0,4,34,4e-06,0,1,0.0,4,35,4e-06,8700223
1,2020-08-14,4,39,1,20,3,19,0,0,4,38,4e-06,0,1,0.0,4,39,4e-06,8700223
1,2020-08-16,1,40,1,21,0,19,0,0,1,39,4e-06,0,1,0.0,1,40,5e-06,8700223
1,2020-08-17,4,44,1,22,3,22,0,0,4,43,5e-06,0,1,0.0,4,44,5e-06,8700223
1,2020-08-18,3,47,1,23,2,24,0,0,3,46,5e-06,0,1,0.0,3,47,5e-06,8700223
1,2020-08-19,3,50,2,25,1,25,0,0,3,49,6e-06,0,1,0.0,3,50,6e-06,8700223
1,2020-08-20,7,57,5,30,2,27,0,0,6,55,6e-06,1,2,0.0,7,57,7e-06,8700223
1,2020-08-21,2,59,0,30,2,29,0,0,2,57,7e-06,0,2,0.0,2,59,7e-06,8700223
1,2020-08-22,1,60,1,31,0,29,0,0,1,58,7e-06,0,2,0.0,1,60,7e-06,8700223
1,2020-08-23,1,61,1,32,0,29,0,0,1,59,7e-06,0,2,0.0,1,61,7e-06,8700223
1,2020-08-24,4,65,1,33,3,32,0,0,4,63,7e-06,0,2,0.0,4,65,7e-06,8700223
1,2020-08-25,4,69,2,35,2,34,0,0,4,67,8e-06,0,2,0.0,4,69,8e-06,8700223
1,2020-08-26,5,74,3,38,2,36,0,0,4,70,8e-06,1,3,0.0,4,73,8e-06,8700223
1,2020-08-27,8,82,6,44,2,38,0,0,5,73,8e-06,3,6,1e-06,6,79,9e-06,8700223
1,2020-08-28,6,88,5,49,1,39,0,0,5,77,9e-06,1,7,1e-06,5,84,1e-05,8700223
1,2020-08-29,1,89,0,49,1,40,0,0,0,76,9e-06,1,8,1e-06,0,84,1e-05,8700223
1,2020-08-30,3,92,3,52,0,40,0,0,3,79,9e-06,0,8,1e-06,3,87,1e-05,8700223
1,2020-08-31,7,99,3,55,4,44,0,0,5,82,9e-06,2,10,1e-06,5,92,1.1e-05,8700223
1,2020-09-01,10,109,6,61,4,48,0,0,7,86,1e-05,3,13,1e-06,7,99,1.1e-05,8700223
1,2020-09-02,7,116,7,68,0,48,0,0,5,89,1e-05,2,15,2e-06,5,104,1.2e-05,8700223
1,2020-09-03,6,122,4,72,2,50,0,0,6,95,1.1e-05,0,15,2e-06,6,110,1.3e-05,8700223
1,2020-09-04,7,129,6,78,1,51,0,0,4,96,1.1e-05,3,18,2e-06,4,114,1.3e-05,8700223
1,2020-09-05,1,130,0,78,1,52,0,0,1,97,1.1e-05,0,18,2e-06,1,115,1.3e-05,8700223
1,2020-09-07,1,131,0,78,1,53,0,0,1,98,1.1e-05,0,18,2e-06,1,116,1.3e-05,8700223
1,2020-09-08,10,141,5,83,5,58,0,0,5,98,1.1e-05,5,23,3e-06,5,121,1.4e-05,8700223
1,2020-09-09,7,148,4,87,3,61,0,0,1,93,1.1e-05,6,29,3e-06,1,122,1.4e-05,8700223
1,2020-09-10,4,152,3,90,1,62,0,0,2,93,1.1e-05,2,31,4e-06,2,124,1.4e-05,8700223
1,2020-09-11,9,161,6,96,3,65,0,0,6,96,1.1e-05,3,34,4e-06,6,130,1.5e-05,8700223
1,2020-09-12,3,164,2,98,1,66,0,0,2,97,1.1e-05,1,35,4e-06,2,132,1.5e-05,8700223
1,2020-09-13,1,165,1,99,0,66,0,0,0,96,1.1e-05,1,36,4e-06,0,132,1.5e-05,8700223
1,2020-09-14,10,175,4,103,6,72,0,0,2,91,1e-05,7,43,5e-06,2,134,1.5e-05,8700223
1,2020-09-15,4,179,3,106,1,73,0,0,0,87,1e-05,4,47,5e-06,0,134,1.5e-05,8700223
1,2020-09-16,5,184,3,109,2,75,0,0,1,84,1e-05,4,51,6e-06,1,135,1.6e-05,8700223
1,2020-09-17,9,193,4,113,5,80,0,0,3,81,9e-06,6,57,7e-06,3,138,1.6e-05,8700223
1,2020-09-18,7,200,7,120,0,80,0,0,2,78,9e-06,5,62,7e-06,2,140,1.6e-05,8700223
1,2020-09-19,2,202,2,122,0,80,0,0,2,80,9e-06,0,62,7e-06,2,142,1.6e-05,8700223
1,2020-09-20,2,204,0,122,2,82,0,0,0,78,9e-06,2,64,7e-06,0,142,1.6e-05,8700223
1,2020-09-21,5,209,3,125,2,84,0,0,3,79,9e-06,2,66,8e-06,3,145,1.7e-05,8700223
1,2020-09-22,6,215,4,129,2,86,0,0,4,81,9e-06,2,68,8e-06,4,149,1.7e-05,8700223
1,2020-09-23,12,227,10,139,2,88,0,0,5,79,9e-06,7,75,9e-06,5,154,1.8e-05,8700223
1,2020-09-24,8,235,8,147,0,88,0,0,4,79,9e-06,4,79,9e-06,4,158,1.8e-05,8700223
1,2020-09-25,6,241,6,153,0,88,0,0,3,79,9e-06,3,82,9e-06,3,161,1.9e-05,8700223
1,2020-09-27,1,242,1,154,0,88,0,0,1,80,9e-06,0,82,9e-06,1,162,1.9e-05,8700223
1,2020-09-28,4,246,2,156,2,90,0,0,1,78,9e-06,3,85,1e-05,1,163,1.9e-05,8700223
1,2020-09-29,6,252,3,159,2,92,1,1,0,73,8e-06,6,91,1e-05,1,164,1.9e-05,8700223
1,2020-09-30,6,258,3,162,3,95,0,1,1,69,8e-06,5,96,1.1e-05,1,165,1.9e-05,8700223
1,2020-10-01,8,266,1,163,5,100,2,3,4,71,8e-06,4,100,1.1e-05,6,171,2e-05,8700223
1,2020-10-02,4,270,4,167,0,100,0,3,1,69,8e-06,3,103,1.2e-05,1,172,2e-05,8700223
1,2020-10-05,4,274,3,170,1,101,0,3,1,68,8e-06,2,105,1.2e-05,1,173,2e-05,8700223
1,2020-10-06,1,275,1,171,0,101,0,3,0,67,8e-06,1,106,1.2e-05,0,173,2e-05,8700223
1,2020-10-07,1,276,1,172,0,101,0,3,0,66,8e-06,1,107,1.2e-05,0,173,2e-05,8700223
1,2020-10-08,4,280,4,176,0,101,0,3,2,66,8e-06,2,109,1.3e-05,2,175,2e-05,8700223
1,2020-10-09,4,284,3,179,1,102,0,3,0,62,7e-06,4,113,1.3e-05,0,175,2e-05,8700223
1,2020-10-10,2,286,1,180,1,103,0,3,1,62,7e-06,1,114,1.3e-05,1,176,2e-05,8700223
1,2020-10-12,2,288,1,181,1,104,0,3,0,60,7e-06,2,116,1.3e-05,0,176,2e-05,8700223
1,2020-10-13,7,295,6,187,1,105,0,3,0,53,6e-06,7,123,1.4e-05,0,176,2e-05,8700223
1,2020-10-14,3,298,3,190,0,105,0,3,0,50,6e-06,3,126,1.4e-05,0,176,2e-05,8700223
1,2020-10-15,4,302,4,194,0,105,0,3,1,48,6e-06,3,129,1.5e-05,1,177,2e-05,8700223
1,2020-10-16,1,303,1,195,0,105,0,3,1,49,6e-06,0,129,1.5e-05,1,178,2e-05,8700223
1,2020-10-17,2,305,2,197,0,105,0,3,2,51,6e-06,0,129,1.5e-05,2,180,2.1e-05,8700223
1,2020-10-18,1,306,1,198,0,105,0,3,1,52,6e-06,0,129,1.5e-05,1,181,2.1e-05,8700223
1,2020-10-19,6,312,4,202,1,106,1,4,4,55,6e-06,2,131,1.5e-05,5,186,2.1e-05,8700223
1,2020-10-20,3,315,1,203,2,108,0,4,2,56,6e-06,1,132,1.5e-05,2,188,2.2e-05,8700223
1,2020-10-21,3,318,2,205,1,109,0,4,2,57,7e-06,1,133,1.5e-05,2,190,2.2e-05,8700223
1,2020-10-23,3,321,1,206,2,111,0,4,2,58,7e-06,1,134,1.5e-05,2,192,2.2e-05,8700223
1,2020-10-24,1,322,1,207,0,111,0,4,1,59,7e-06,0,134,1.5e-05,1,193,2.2e-05,8700223
1,2020-10-26,1,323,0,207,1,112,0,4,0,58,7e-06,1,135,1.6e-05,0,193,2.2e-05,8700223
1,2020-10-27,4,327,4,211,0,112,0,4,3,60,7e-06,1,136,1.6e-05,3,196,2.3e-05,8700223
1,2020-10-28,1,328,0,211,1,113,0,4,0,59,7e-06,1,137,1.6e-05,0,196,2.3e-05,8700223
1,2020-10-29,1,329,0,211,1,114,0,4,1,60,7e-06,0,137,1.6e-05,1,197,2.3e-05,8700223
1,2020-10-30,3,332,3,214,0,114,0,4,2,61,7e-06,1,138,1.6e-05,2,199,2.3e-05,8700223
1,2020-10-31,1,333,0,214,0,114,1,5,0,61,7e-06,1,139,1.6e-05,1,200,2.3e-05,8700223
1,2020-11-01,3,336,1,215,2,116,0,5,3,64,7e-06,0,139,1.6e-05,3,203,2.3e-05,8700223
1,2020-11-02,5,341,1,216,3,119,1,6,3,66,8e-06,2,141,1.6e-05,4,207,2.4e-05,8700223
1,2020-11-04,2,343,1,217,1,120,0,6,2,68,8e-06,0,141,1.6e-05,2,209,2.4e-05,8700223
1,2020-11-05,2,345,2,219,0,120,0,6,2,70,8e-06,0,141,1.6e-05,2,211,2.4e-05,8700223
1,2020-11-07,1,346,1,220,0,120,0,6,0,69,8e-06,1,142,1.6e-05,0,211,2.4e-05,8700223
1,2020-11-10,1,347,0,220,0,120,1,7,0,69,8e-06,1,143,1.6e-05,1,212,2.4e-05,8700223
1,2020-11-11,3,350,1,221,1,121,1,8,1,69,8e-06,2,145,1.7e-05,2,214,2.5e-05,8700223
1,2020-11-12,1,351,1,222,0,121,0,8,0,68,8e-06,1,146,1.7e-05,0,214,2.5e-05,8700223
1,2020-11-13,4,355,3,225,0,121,1,9,0,65,7e-06,4,150,1.7e-05,1,215,2.5e-05,8700223
1,2020-11-14,3,358,1,226,0,121,2,11,1,66,8e-06,2,152,1.7e-05,3,218,2.5e-05,8700223
1,2020-11-15,3,361,0,226,1,122,2,13,1,67,8e-06,2,154,1.8e-05,3,221,2.5e-05,8700223
1,2020-11-16,4,365,1,227,0,122,3,16,1,68,8e-06,3,157,1.8e-05,4,225,2.6e-05,8700223
1,2020-11-17,6,371,5,232,1,123,0,16,2,67,8e-06,4,161,1.9e-05,3,228,2.6e-05,8700223
1,2020-11-19,4,375,1,233,1,124,2,18,0,66,8e-06,3,164,1.9e-05,2,230,2.6e-05,8700223
1,2020-11-20,6,381,2,235,0,124,4,22,2,68,8e-06,4,168,1.9e-05,6,236,2.7e-05,8700223
1,2020-11-21,2,383,1,236,1,125,0,22,2,70,8e-06,0,168,1.9e-05,2,238,2.7e-05,8700223
1,2020-11-22,5,388,2,238,0,125,3,25,2,72,8e-06,3,171,2e-05,5,243,2.8e-05,8700223
1,2020-11-23,3,391,2,240,1,126,0,25,2,74,9e-06,0,171,2e-05,2,245,2.8e-05,8700223
1,2020-11-24,3,394,1,241,1,127,1,26,2,76,9e-06,1,172,2e-05,3,248,2.9e-05,8700223
1,2020-11-25,1,395,0,241,1,128,0,26,1,77,9e-06,0,172,2e-05,1,249,2.9e-05,8700223
1,2020-11-26,2,397,0,241,1,129,1,27,0,77,9e-06,1,173,2e-05,1,250,2.9e-05,8700223
1,2020-11-27,2,399,0,241,0,129,2,29,0,77,9e-06,2,175,2e-05,2,252,2.9e-05,8700223
1,2020-11-28,3,402,2,243,1,130,0,29,3,80,9e-06,0,175,2e-05,3,255,2.9e-05,8700223
1,2020-11-29,2,404,0,243,2,132,0,29,1,80,9e-06,1,176,2e-05,1,256,2.9e-05,8700223
1,2020-11-30,1,405,1,244,0,132,0,29,1,81,9e-06,0,176,2e-05,1,257,3e-05,8700223
1,2020-12-01,38,443,22,266,16,148,0,29,34,112,1.3e-05,4,180,2.1e-05,35,292,3.4e-05,8700223
1,2020-12-02,4,447,3,269,0,148,1,30,3,115,1.3e-05,1,181,2.1e-05,4,296,3.4e-05,8700223
1,2020-12-03,13,460,5,274,8,156,0,30,14,129,1.5e-05,0,181,2.1e-05,14,310,3.6e-05,8700223
1,2020-12-04,4,464,1,275,1,157,2,32,2,131,1.5e-05,2,183,2.1e-05,4,314,3.6e-05,8700223
1,2020-12-05,6,470,4,279,0,157,2,34,3,133,1.5e-05,3,186,2.1e-05,5,319,3.7e-05,8700223
1,2020-12-06,4,474,4,283,0,157,0,34,4,137,1.6e-05,0,186,2.1e-05,4,323,3.7e-05,8700223
1,2020-12-07,11,485,5,288,5,162,1,35,10,147,1.7e-05,1,187,2.1e-05,11,334,3.8e-05,8700223
1,2020-12-08,9,494,5,293,2,164,2,37,8,155,1.8e-05,2,189,2.2e-05,10,344,4e-05,8700223
1,2020-12-09,7,501,5,298,1,165,1,38,5,159,1.8e-05,2,191,2.2e-05,6,350,4e-05,8700223
1,2020-12-10,9,510,4,302,2,167,3,41,6,165,1.9e-05,3,194,2.2e-05,9,359,4.1e-05,8700223
1,2020-12-11,16,526,5,307,5,172,6,47,9,174,2e-05,6,200,2.3e-05,15,374,4.3e-05,8700223
1,2020-12-12,8,534,2,309,5,177,1,48,7,181,2.1e-05,1,201,2.3e-05,8,382,4.4e-05,8700223
1,2020-12-13,6,540,5,314,1,178,0,48,6,187,2.1e-05,0,201,2.3e-05,6,388,4.5e-05,8700223
1,2020-12-14,12,552,4,318,5,183,3,51,9,196,2.3e-05,3,204,2.3e-05,12,400,4.6e-05,8700223
1,2020-12-15,164,716,152,470,9,192,3,54,159,355,4.1e-05,4,208,2.4e-05,163,563,6.5e-05,8700223
1,2020-12-16,1284,2000,1283,1753,1,193,0,54,1267,1620,0.000186,5,213,2.4e-05,1270,1833,0.000211,8700223
1,2020-12-17,4272,6272,4265,6018,5,198,2,56,4247,5864,0.000674,7,220,2.5e-05,4251,6084,0.000699,8700223
1,2020-12-18,6458,12730,6433,12451,24,222,1,57,6422,12277,0.001411,18,238,2.7e-05,6431,12515,0.001438,8700223
1,2020-12-19,2972,15702,2969,15420,3,225,0,57,2960,15233,0.001751,8,246,2.8e-05,2964,15479,0.001779,8700223
1,2020-12-20,2194,17896,2178,17598,16,241,0,57,2187,17418,0.002002,4,250,2.9e-05,2189,17668,0.002031,8700223
1,2020-12-21,7727,25623,7707,25305,20,261,0,57,7696,25103,0.002885,28,278,3.2e-05,7713,25381,0.002917,8700223
1,2020-12-22,7515,33138,7093,32398,422,683,0,57,7440,32533,0.003739,19,297,3.4e-05,7449,32830,0.003773,8700223
1,2020-12-23,8061,41199,6679,39077,1382,2065,0,57,7967,40490,0.004654,22,319,3.7e-05,7979,40809,0.004691,8700223
1,2020-12-24,3341,44540,2358,41435,982,3047,1,58,3322,43808,0.005035,10,329,3.8e-05,3328,44137,0.005073,8700223
1,2020-12-25,248,44788,163,41598,85,3132,0,58,247,44054,0.005064,1,330,3.8e-05,247,44384,0.005101,8700223
1,2020-12-26,1471,46259,985,42583,486,3618,0,58,1463,45515,0.005231,3,333,3.8e-05,1464,45848,0.00527,8700223
1,2020-12-27,913,47172,546,43129,367,3985,0,58,909,46421,0.005336,3,336,3.9e-05,909,46757,0.005374,8700223
1,2020-12-28,7218,54390,4791,47920,2426,6411,1,59,7144,53552,0.006155,19,355,4.1e-05,7150,53907,0.006196,8700223
1,2020-12-29,9206,63596,5122,53042,4084,10495,0,59,9121,62654,0.007201,29,384,4.4e-05,9131,63038,0.007246,8700223
1,2020-12-30,11838,75434,6551,59593,5287,15782,0,59,11761,74390,0.00855,33,417,4.8e-05,11769,74807,0.008598,8700223
1,2020-12-31,6051,81485,1964,61557,4087,19869,0,59,6013,80380,0.009239,27,444,5.1e-05,6017,80824,0.00929,8700223
1,2021-01-01,683,82168,279,61836,395,20264,9,68,653,81016,0.009312,26,470,5.4e-05,662,81486,0.009366,8700223
1,2021-01-02,2959,85127,1788,63624,1170,21434,1,69,2955,83970,0.009651,3,473,5.4e-05,2957,84443,0.009706,8700223
1,2021-01-03,1060,86187,549,64173,509,21943,2,71,1052,85019,0.009772,5,478,5.5e-05,1054,85497,0.009827,8700223
1,2021-01-04,7825,94012,3975,68148,3847,25790,3,74,7476,92170,0.010594,330,808,9.3e-05,7481,92978,0.010687,8700223
1,2021-01-05,11016,105028,5291,73439,5723,31513,2,76,10155,101561,0.011673,787,1595,0.000183,10178,103156,0.011857,8700223
1,2021-01-06,14311,119339,7097,80536,7214,38727,0,76,12315,111998,0.012873,1891,3486,0.000401,12328,115484,0.013274,8700223
1,2021-01-07,17713,137052,9203,89739,8507,47234,3,79,13043,120567,0.013858,4486,7972,0.000916,13055,128539,0.014774,8700223
1,2021-01-08,20285,157337,10441,100180,9843,57077,1,80,14221,128815,0.014806,5987,13959,0.001604,14235,142774,0.01641,8700223
1,2021-01-09,6821,164158,3492,103672,3329,60406,0,80,4863,131734,0.015141,1944,15903,0.001828,4863,147637,0.016969,8700223
1,2021-01-10,3182,167340,1817,105489,1364,61770,1,81,1921,132417,0.01522,1238,17141,0.00197,1921,149558,0.01719,8700223
1,2021-01-11,18380,185720,12012,117501,6367,68137,1,82,11601,137377,0.01579,6661,23802,0.002736,11621,161179,0.018526,8700223
1,2021-01-12,19354,205074,11118,128619,8236,76373,0,82,13150,144500,0.016609,6067,29869,0.003433,13190,174369,0.020042,8700223
1,2021-01-13,19964,225038,10804,139423,9160,85533,0,82,14658,153980,0.017698,5198,35067,0.004031,14678,189047,0.021729,8700223
1,2021-01-14,22192,247230,9514,148937,12677,98210,1,83,19285,170614,0.01961,2714,37781,0.004343,19348,208395,0.023953,8700223
1,2021-01-15,25373,272603,9315,158252,16057,114267,1,84,23312,192065,0.022076,1930,39711,0.004564,23381,231776,0.02664,8700223
1,2021-01-16,13956,286559,4570,162822,9386,123653,0,84,13030,204202,0.023471,896,40607,0.004667,13033,244809,0.028138,8700223
1,2021-01-17,5326,291885,2050,164872,3275,126928,1,85,4927,208744,0.023993,388,40995,0.004712,4930,249739,0.028705,8700223
1,2021-01-18,14513,306398,8708,173580,5804,132732,1,86,11224,216790,0.024918,3237,44232,0.005084,11283,261022,0.030002,8700223
1,2021-01-19,24975,331373,13017,186597,11957,144689,1,87,19503,231026,0.026554,5281,49513,0.005691,19517,280539,0.032245,8700223
1,2021-01-20,29556,360929,14781,201378,14772,159461,3,90,23458,248586,0.028572,5927,55440,0.006372,23487,304026,0.034945,8700223
1,2021-01-21,31563,392492,14883,216261,16678,176139,2,92,27946,273232,0.031405,3393,58833,0.006762,28039,332065,0.038167,8700223
1,2021-01-22,28629,421121,11327,227588,17302,193441,0,92,26372,297518,0.034197,2113,60946,0.007005,26399,358464,0.041202,8700223
1,2021-01-23,18725,439846,8247,235835,10478,203919,0,92,16725,312284,0.035894,1968,62914,0.007231,16734,375198,0.043125,8700223
1,2021-01-24,6667,446513,4148,239983,2519,206438,0,92,5971,317599,0.036505,660,63574,0.007307,5975,381173,0.043812,8700223
1,2021-01-25,25744,472257,10685,250668,15058,221496,1,93,19695,331493,0.038102,5909,69483,0.007986,19803,400976,0.046088,8700223
1,2021-01-26,29089,501346,13666,264334,15421,236917,2,95,22044,346689,0.039848,6865,76348,0.008775,22061,423037,0.048624,8700223
1,2021-01-27,32994,534340,15738,280072,17256,254173,0,95,24532,363009,0.041724,8285,84633,0.009728,24605,447642,0.051452,8700223
1,2021-01-28,35130,569470,16552,296624,18577,272750,1,96,27905,383987,0.044135,7052,91685,0.010538,28030,475672,0.054674,8700223
1,2021-01-29,34071,603541,16601,313225,17468,290218,2,98,27237,404710,0.046517,6615,98300,0.011299,27338,503010,0.057816,8700223
1,2021-01-30,20312,623853,8779,322004,11532,301750,1,99,18042,420626,0.048347,2212,100512,0.011553,18128,521138,0.059899,8700223
1,2021-01-31,7802,631655,5084,327088,2718,304468,0,99,7053,426965,0.049075,716,101228,0.011635,7055,528193,0.06071,8700223
1,2021-02-01,29347,661002,12658,339746,16668,321136,21,120,21317,440387,0.050618,7921,109149,0.012546,21343,549536,0.063163,8700223
1,2021-02-02,32992,693994,11937,351683,21050,342186,5,125,24555,456607,0.052482,8357,117506,0.013506,24577,574113,0.065988,8700223
1,2021-02-03,39847,733841,15307,366990,24540,366726,0,125,28394,473918,0.054472,11174,128680,0.01479,28485,602598,0.069262,8700223
1,2021-02-04,44278,778119,17242,384232,27033,393759,3,128,31722,493379,0.056709,12352,141032,0.01621,31813,634411,0.072919,8700223
1,2021-02-05,47715,825834,17281,401513,30434,424193,0,128,30929,507936,0.058382,16470,157502,0.018103,31027,665438,0.076485,8700223
1,2021-02-06,26988,852822,10667,412180,16306,440499,15,143,20862,522835,0.060094,6041,163543,0.018798,20940,686378,0.078892,8700223
1,2021-02-07,6476,859298,4106,416286,2368,442867,2,145,4712,525836,0.060439,1719,165262,0.018995,4720,691098,0.079435,8700223
1,2021-02-08,32024,891322,14616,430902,17405,460272,3,148,21205,536421,0.061656,10661,175923,0.020221,21246,712344,0.081877,8700223
1,2021-02-09,38868,930190,17166,448068,21698,481970,4,152,23737,545208,0.062666,15031,190954,0.021948,23818,736162,0.084614,8700223
1,2021-02-10,47591,977781,22212,470280,25376,507346,3,155,26916,551695,0.063412,20475,211429,0.024302,26962,763124,0.087713,8700223
1,2021-02-11,52374,1030155,25626,495906,26742,534088,6,161,30948,561761,0.064569,20934,232363,0.026708,31000,794124,0.091276,8700223
1,2021-02-12,50350,1080505,21605,517511,28737,562825,8,169,28683,569092,0.065411,21417,253780,0.029169,28748,822872,0.094581,8700223
1,2021-02-13,26477,1106982,11532,529043,14944,577769,1,170,15099,572973,0.065857,11243,265023,0.030462,15124,837996,0.096319,8700223
1,2021-02-14,11861,1118843,5584,534627,6275,584044,2,172,6695,574575,0.066041,5112,270135,0.031049,6714,844710,0.097091,8700223
1,2021-02-15,24160,1143003,9484,544111,14663,598707,13,185,14562,579737,0.066635,9439,279574,0.032134,14601,859311,0.098769,8700223
1,2021-02-16,47492,1190495,22635,566746,24849,623556,8,193,27287,587039,0.067474,20043,299617,0.034438,27345,886656,0.101912,8700223
1,2021-02-17,48843,1239338,24809,591555,24020,647576,14,207,25911,590328,0.067852,22693,322310,0.037046,25982,912638,0.104898,8700223
1,2021-02-18,51475,1290813,25819,617374,25650,673226,6,213,26276,591837,0.068025,24852,347162,0.039903,26361,938999,0.107928,8700223
1,2021-02-19,46968,1337781,25430,642804,21530,694756,8,221,25917,597001,0.068619,20794,367956,0.042293,25958,964957,0.110912,8700223
1,2021-02-20,27976,1365757,17016,659820,10957,705713,3,224,15858,600865,0.069063,12031,379987,0.043676,15895,980852,0.112739,8700223
1,2021-02-21,12586,1378343,10807,670627,1776,707489,3,227,7386,603143,0.069325,5131,385118,0.044265,7409,988261,0.11359,8700223
1,2021-02-22,31853,1410196,20836,691463,11009,718498,8,235,18104,607686,0.069847,13627,398745,0.045832,18170,1006431,0.115679,8700223
1,2021-02-23,46048,1456244,22402,713865,23639,742137,7,242,24944,611981,0.070341,20800,419545,0.048222,25095,1031526,0.118563,8700223
1,2021-02-24,55978,1512222,27028,740893,28948,771085,2,244,30404,617248,0.070946,25277,444822,0.051128,30544,1062070,0.122074,8700223
1,2021-02-25,68711,1580933,33432,774325,35274,806359,5,249,42274,633542,0.072819,26109,470931,0.054129,42403,1104473,0.126948,8700223
1,2021-02-26,76865,1657798,36008,810333,40847,847206,10,259,49895,657052,0.075521,26511,497442,0.057176,50021,1154494,0.132697,8700223
1,2021-02-27,53166,1710964,24517,834850,28639,875845,10,269,34480,673418,0.077402,18191,515633,0.059267,34557,1189051,0.136669,8700223
1,2021-02-28,20501,1731465,12187,847037,8311,884156,3,272,14898,682856,0.078487,5496,521129,0.059898,14934,1203985,0.138386,8700223
1,2021-03-01,47019,1778484,21649,868686,25294,909450,76,348,30040,696334,0.080036,16727,537856,0.061821,30205,1234190,0.141857,8700223
1,2021-03-02,65620,1844104,28449,897135,37156,946606,15,363,41415,713969,0.082063,23937,561793,0.064572,41572,1275762,0.146636,8700223
1,2021-03-03,72604,1916708,34602,931737,37968,984574,34,397,43689,729223,0.083817,28607,590400,0.06786,43861,1319623,0.151677,8700223
1,2021-03-04,80858,1997566,37974,969711,42844,1027418,40,437,51169,751192,0.086342,29365,619765,0.071236,51334,1370957,0.157577,8700223
1,2021-03-05,80523,2078089,36096,1005807,44198,1071616,229,666,53251,778008,0.089424,26811,646576,0.074317,53627,1424584,0.163741,8700223
1,2021-03-06,58869,2136958,27776,1033583,29715,1101331,1378,2044,39526,799841,0.091933,19123,665699,0.076515,40956,1465540,0.168449,8700223
1,2021-03-07,21821,2158779,13469,1047052,7130,1108461,1222,3266,15997,811333,0.093254,5763,671462,0.077178,17255,1482795,0.170432,8700223
1,2021-03-08,46752,2205531,22762,1069814,21970,1130431,2020,5286,32478,831778,0.095604,14116,685578,0.0788,34561,1517356,0.174404,8700223
1,2021-03-09,67788,2273319,32799,1102613,32319,1162750,2670,7956,41193,849408,0.097631,26328,711906,0.081826,43958,1561314,0.179457,8700223
1,2021-03-10,74869,2348188,37212,1139825,33100,1195850,4557,12513,45387,870230,0.100024,29203,741109,0.085183,50025,1611339,0.185207,8700223
1,2021-03-11,91125,2439313,41848,1181673,41168,1237018,8109,20622,52445,892619,0.102597,38262,779371,0.089581,60651,1671990,0.192178,8700223
1,2021-03-12,100260,2539573,43988,1225661,43849,1280867,12423,33045,57919,921055,0.105866,41930,821301,0.0944,70366,1742356,0.200266,8700223
1,2021-03-13,66037,2605610,29646,1255307,28644,1309511,7747,40792,41384,945817,0.108712,24419,845720,0.097207,49181,1791537,0.205919,8700223
1,2021-03-14,28218,2633828,15092,1270399,9548,1319059,3578,44370,15729,952781,0.109512,12359,858079,0.098627,19323,1810860,0.208139,8700223
1,2021-03-15,65884,2699712,28970,1299369,30134,1349193,6780,51150,38585,971178,0.111627,27007,885086,0.101731,45404,1856264,0.213358,8700223
1,2021-03-16,86306,2786018,39305,1338674,41323,1390516,5678,56828,53066,997103,0.114607,32874,917960,0.10551,58799,1915063,0.220117,8700223
1,2021-03-17,93822,2879840,45727,1384401,41542,1432058,6553,63381,60002,1030204,0.118411,33466,951426,0.109357,66567,1981630,0.227768,8700223
1,2021-03-18,99383,2979223,51190,1435591,42435,1474493,5758,69139,59758,1056658,0.121452,39145,990571,0.113856,65599,2047229,0.235308,8700223
1,2021-03-19,104648,3083871,54197,1489788,44195,1518688,6256,75395,60929,1080554,0.124198,43308,1033879,0.118834,67204,2114433,0.243032,8700223
1,2021-03-20,73037,3156908,37289,1527077,30517,1549205,5231,80626,46638,1106274,0.127155,26155,1060034,0.12184,51875,2166308,0.248995,8700223
1,2021-03-21,27515,3184423,19133,1546210,6563,1555768,1819,82445,17022,1114738,0.128128,10382,1070416,0.123033,18846,2185154,0.251161,8700223
1,2021-03-22,59477,3243900,30762,1576972,25410,1581178,3305,85750,39784,1138382,0.130845,19468,1089884,0.125271,43112,2228266,0.256116,8700223
1,2021-03-23,83817,3327717,42631,1619603,37500,1618678,3686,89436,51075,1160717,0.133412,32478,1122362,0.129004,54813,2283079,0.262416,8700223
1,2021-03-24,89058,3416775,44983,1664586,39679,1658357,4396,93832,52843,1182056,0.135865,35916,1158278,0.133132,57255,2340334,0.268997,8700223
1,2021-03-25,97789,3514564,49929,1714515,41954,1700311,5906,99738,53915,1198366,0.13774,43527,1201805,0.138135,59837,2400171,0.275875,8700223
1,2021-03-26,106810,3621374,51820,1766335,48633,1748944,6357,106095,57205,1212767,0.139395,49202,1251007,0.14379,63603,2463774,0.283185,8700223
1,2021-03-27,74771,3696145,38535,1804870,32013,1780957,4223,110318,38331,1219154,0.140129,36194,1287201,0.14795,42581,2506355,0.288079,8700223
1,2021-03-28,33009,3729154,21560,1826430,10224,1791181,1225,111543,16369,1220244,0.140254,16532,1303733,0.149851,17622,2523977,0.290105,8700223
1,2021-03-29,69041,3798195,33960,1860390,31855,1823036,3226,114769,37791,1230299,0.14141,30994,1334727,0.153413,41049,2565026,0.294823,8700223
1,2021-03-30,94081,3892276,45931,1906321,41712,1864748,6438,121207,47847,1238586,0.142363,45975,1380702,0.158697,54262,2619288,0.30106,8700223
1,2021-03-31,102477,3994753,53155,1959476,43047,1907795,6275,127482,55872,1254494,0.144191,46237,1426939,0.164012,62145,2681433,0.308203,8700223
1,2021-04-01,114281,4109034,54302,2013778,51101,1958896,8878,136360,57564,1264730,0.145368,56182,1483121,0.170469,66418,2747851,0.315837,8700223
1,2021-04-02,113454,4222488,51738,2065516,51907,2010803,9809,146169,57236,1276032,0.146667,55734,1538855,0.176875,67036,2814887,0.323542,8700223
1,2021-04-03,78642,4301130,39400,2104916,29521,2040324,9721,155890,36594,1280505,0.147181,41833,1580688,0.181684,46306,2861193,0.328864,8700223
1,2021-04-04,23871,4325001,11908,2116824,8477,2048801,3486,159376,9744,1279669,0.147085,14058,1594746,0.183299,13222,2874415,0.330384,8700223
1,2021-04-05,78406,4403407,37161,2153985,31683,2080484,9562,168938,34759,1280591,0.147191,43408,1638154,0.188289,44330,2918745,0.335479,8700223
1,2021-04-06,104981,4508388,49529,2203514,38688,2119172,16764,185702,47088,1286862,0.147911,57547,1695701,0.194903,63818,2982563,0.342815,8700223
1,2021-04-07,113128,4621516,54659,2258173,40752,2159924,17717,203419,50668,1293089,0.148627,62129,1757830,0.202044,68356,3050919,0.350671,8700223
1,2021-04-08,123633,4745149,58370,2316543,44026,2203950,21237,224656,54232,1299559,0.149371,68932,1826762,0.209967,75402,3126321,0.359338,8700223
1,2021-04-09,125159,4870308,56957,2373500,47201,2251151,21001,245657,54452,1304631,0.149954,70327,1897089,0.218051,75399,3201720,0.368004,8700223
1,2021-04-10,97553,4967861,43225,2416725,31407,2282558,22921,268578,38353,1306869,0.150211,58967,1956056,0.224828,61205,3262925,0.375039,8700223
1,2021-04-11,37011,5004872,20524,2437249,9582,2292140,6905,275483,14898,1306605,0.150181,22050,1978106,0.227363,21786,3284711,0.377543,8700223
1,2021-04-12,75597,5080469,33654,2470903,31820,2323960,10123,285606,31862,1305132,0.150011,43441,2021547,0.232356,41968,3326679,0.382367,8700223
1,2021-04-13,98632,5179101,52694,2523597,45595,2369555,343,285949,53057,1313346,0.150955,45240,2066787,0.237556,53454,3380133,0.388511,8700223
1,2021-04-14,105586,5284687,54582,2578179,50920,2420475,84,286033,53365,1315121,0.151159,51743,2118530,0.243503,53518,3433651,0.394662,8700223
1,2021-04-15,106412,5391099,57792,2635971,48523,2468998,97,286130,56191,1321754,0.151922,49702,2168232,0.249216,56335,3489986,0.401138,8700223
1,2021-04-16,111910,5503009,57343,2693314,54472,2523470,95,286225,55631,1321662,0.151911,55861,2224093,0.255636,55769,3545755,0.407548,8700223
1,2021-04-17,83750,5586759,45433,2738747,38305,2561775,12,286237,46584,1331409,0.153032,36897,2260990,0.259877,46644,3592399,0.412909,8700223
1,2021-04-18,30752,5617511,20804,2759551,9941,2571716,7,286244,15344,1331461,0.153038,15322,2276312,0.261638,15374,3607773,0.414676,8700223
1,2021-04-19,67334,5684845,34087,2793638,33230,2604946,17,286261,30089,1324822,0.152274,36780,2313092,0.265866,30141,3637914,0.41814,8700223
1,2021-04-20,88621,5773466,44582,2838220,44013,2648959,26,286287,40833,1318530,0.151551,47193,2360285,0.27129,40901,3678815,0.422841,8700223
1,2021-04-21,98296,5871762,51084,2889304,47105,2696064,107,286394,43653,1308263,0.150371,54079,2414364,0.277506,43812,3722627,0.427877,8700223
1,2021-04-22,98123,5969885,51122,2940426,46981,2743045,20,286414,44801,1300336,0.14946,52803,2467167,0.283575,44876,3767503,0.433035,8700223
1,2021-04-23,103474,6073359,53319,2993745,50127,2793172,28,286442,48847,1295201,0.14887,54056,2521223,0.289788,48921,3816424,0.438658,8700223
1,2021-04-24,76950,6150309,47548,3041293,29374,2822546,28,286470,43186,1304896,0.149984,33578,2554801,0.293648,43273,3859697,0.443632,8700223
1,2021-04-25,27522,6177831,17517,3058810,9988,2832534,17,286487,15602,1308763,0.150429,11780,2566581,0.295002,15647,3875344,0.44543,8700223
1,2021-04-26,66644,6244475,34932,3093742,31302,2863836,410,286897,31357,1305595,0.150065,34972,2601553,0.299021,31804,3907148,0.449086,8700223
1,2021-04-27,82276,6326751,43658,3137400,37309,2901145,1309,288206,35398,1295765,0.148935,46573,2648126,0.304374,36743,3943891,0.453309,8700223
1,2021-04-28,81981,6408732,43494,3180894,36974,2938119,1513,289719,35714,1287119,0.147941,45917,2694043,0.309652,37271,3981162,0.457593,8700223
1,2021-04-29,85598,6494330,46905,3227799,37049,2975168,1644,291363,34595,1272770,0.146292,50609,2744652,0.315469,36260,4017422,0.461761,8700223
1,2021-04-30,93637,6587967,50460,3278259,41236,3016404,1941,293304,38780,1259007,0.14471,54503,2799155,0.321734,40740,4058162,0.466443,8700223
1,2021-05-01,64420,6652387,41270,3319529,21692,3038096,1458,294762,27126,1250572,0.14374,37038,2836193,0.325991,28603,4086765,0.469731,8700223
1,2021-05-02,23744,6676131,16854,3336383,6286,3044382,604,295366,9483,1246518,0.143274,14154,2850347,0.327618,10100,4096865,0.470892,8700223
1,2021-05-03,56754,6732885,31411,3367794,23468,3067850,1875,297241,20462,1232812,0.141699,36050,2886397,0.331761,22344,4119209,0.47346,8700223
1,2021-05-04,76264,6809149,43839,3411633,30322,3098172,2103,299344,27103,1213150,0.139439,48886,2935283,0.33738,29224,4148433,0.476819,8700223
1,2021-05-05,78885,6888034,45681,3457314,30888,3129060,2316,301660,26510,1189967,0.136774,52036,2987319,0.343361,28853,4177286,0.480136,8700223
1,2021-05-06,80559,6968593,48915,3506229,29451,3158511,2193,303853,24933,1161925,0.133551,55192,3042511,0.349705,27150,4204436,0.483256,8700223
1,2021-05-07,84142,7052735,47862,3554091,34084,3192595,2196,306049,27831,1136133,0.130587,55840,3098351,0.356123,30048,4234484,0.48671,8700223
1,2021-05-08,57883,7110618,36266,3590357,19953,3212548,1664,307713,19518,1119268,0.128648,38070,3136421,0.360499,21205,4255689,0.489147,8700223
1,2021-05-09,18621,7129239,13376,3603733,4760,3217308,485,308198,5584,1112396,0.127858,12958,3149379,0.361988,6086,4261775,0.489847,8700223
1,2021-05-10,44718,7173957,22622,3626355,20253,3237561,1843,310041,14731,1099255,0.126348,29739,3179118,0.365406,16598,4278373,0.491754,8700223
1,2021-05-11,63294,7237251,34404,3660759,26720,3264281,2170,312211,20651,1079720,0.124103,42363,3221481,0.370276,22828,4301201,0.494378,8700223
1,2021-05-12,63486,7300737,33720,3694479,27689,3291970,2077,314288,20697,1060034,0.12184,42466,3263947,0.375157,22780,4323981,0.496997,8700223
1,2021-05-13,67798,7368535,39756,3734235,26042,3318012,2000,316288,25677,1045991,0.120226,41776,3305723,0.379958,27733,4351714,0.500184,8700223
1,2021-05-14,77688,7446223,46740,3780975,28508,3346520,2440,318728,31217,1033605,0.118802,46065,3351788,0.385253,33679,4385393,0.504055,8700223
1,2021-05-15,67374,7513597,44170,3825145,21427,3367947,1777,320505,26732,1021842,0.11745,40319,3392107,0.389887,28556,4413949,0.507337,8700223
1,2021-05-16,25384,7538981,18690,3843835,6068,3374015,626,321131,10312,1017858,0.116992,14943,3407050,0.391605,10959,4424908,0.508597,8700223
1,2021-05-17,55087,7594068,33608,3877443,19675,3393690,1804,322935,23171,1011208,0.116228,31642,3438692,0.395242,24992,4449900,0.51147,8700223
1,2021-05-18,66053,7660121,39703,3917146,24495,3418185,1855,324790,28469,1004255,0.115429,37291,3475983,0.399528,30338,4480238,0.514957,8700223
1,2021-05-19,67363,7727484,40990,3958136,24417,3442602,1956,326746,29903,998979,0.114822,37150,3513133,0.403798,31874,4512112,0.51862,8700223
1,2021-05-20,65572,7793056,37968,3996104,25354,3467956,2250,328996,26846,989817,0.113769,38336,3551469,0.408204,29174,4541286,0.521974,8700223
1,2021-05-21,71464,7864520,42661,4038765,26912,3494868,1891,330887,29304,979265,0.112556,41778,3593247,0.413006,31226,4572512,0.525563,8700223
1,2021-05-22,56917,7921437,37379,4076144,17793,3512661,1745,332632,24552,973512,0.111895,32100,3625347,0.416696,26347,4598859,0.528591,8700223
1,2021-05-23,20752,7942189,14493,4090637,5669,3518330,590,333222,9567,972594,0.11179,11086,3636433,0.41797,10168,4609027,0.52976,8700223
1,2021-05-24,44648,7986837,24925,4115562,17850,3536180,1873,335095,17962,966043,0.111037,26427,3662860,0.421008,19876,4628903,0.532044,8700223
1,2021-05-25,52128,8038965,30070,4145632,20304,3556484,1754,336849,21642,959303,0.110262,30161,3693021,0.424474,23421,4652324,0.534736,8700223
1,2021-05-26,49325,8088290,27942,4173574,19441,3575925,1942,338791,20819,953863,0.109637,28193,3721214,0.427715,22753,4675077,0.537351,8700223
1,2021-05-27,47786,8136076,26835,4200409,19004,3594929,1947,340738,20354,949056,0.109084,27136,3748350,0.430834,22329,4697406,0.539918,8700223
1,2021-05-28,53614,8189690,29927,4230336,21822,3616751,1865,342603,23812,945316,0.108654,29447,3777797,0.434218,25707,4723113,0.542873,8700223
1,2021-05-29,31048,8220738,18790,4249126,11274,3628025,984,343587,14617,944669,0.10858,16262,3794059,0.436088,15615,4738728,0.544667,8700223
1,2021-05-30,11820,8232558,7638,4256764,3612,3631637,570,344157,5512,944540,0.108565,6223,3800282,0.436803,6094,4744822,0.545368,8700223
1,2021-05-31,5881,8238439,3348,4260112,2271,3633908,262,344419,2047,943089,0.108398,3769,3804051,0.437236,2318,4747140,0.545634,8700223
1,2021-06-01,46850,8285289,26554,4286666,18695,3652603,1601,346020,17600,933423,0.107287,28874,3832925,0.440555,19208,4766348,0.547842,8700223
1,2021-06-02,40793,8326082,23685,4310351,15582,3668185,1526,347546,16353,927194,0.106571,24124,3857049,0.443328,17895,4784243,0.549899,8700223
1,2021-06-03,42426,8368508,26610,4336961,14059,3682244,1757,349303,16106,919074,0.105638,26009,3883058,0.446317,17889,4802132,0.551955,8700223
1,2021-06-04,51221,8419729,32792,4369753,16586,3698830,1843,351146,18308,906716,0.104218,32542,3915600,0.450057,20184,4822316,0.554275,8700223
1,2021-06-05,41290,8461019,28301,4398054,10967,3709797,2022,353168,14284,896274,0.103017,26773,3942373,0.453135,16331,4838647,0.556152,8700223
1,2021-06-06,13326,8474345,10665,4408719,2141,3711938,520,353688,4502,892598,0.102595,8732,3951105,0.454138,5056,4843703,0.556733,8700223
1,2021-06-07,34543,8508888,23804,4432523,9352,3721290,1387,355075,12220,884140,0.101623,22091,3973196,0.456677,13633,4857336,0.5583,8700223
1,2021-06-08,42706,8551594,29549,4462072,11486,3732776,1671,356746,14794,872973,0.100339,27669,4000865,0.459858,16502,4873838,0.560197,8700223
1,2021-06-09,43002,8594596,29927,4491999,11410,3744186,1665,358411,13862,859708,0.098814,28808,4029673,0.463169,15543,4889381,0.561983,8700223
1,2021-06-10,39776,8634372,26815,4518814,11230,3755416,1731,360142,13497,848966,0.09758,26009,4055682,0.466158,15267,4904648,0.563738,8700223
1,2021-06-11,45152,8679524,29966,4548780,13457,3768873,1729,361871,15979,837842,0.096301,28870,4084552,0.469477,17746,4922394,0.565778,8700223
1,2021-06-12,34621,8714145,25100,4573880,8293,3777166,1228,363099,11245,827196,0.095078,23143,4107695,0.472137,12497,4934891,0.567214,8700223
1,2021-06-13,11748,8725893,8543,4582423,2719,3779885,486,363585,3371,822764,0.094568,8301,4115996,0.473091,3869,4938760,0.567659,8700223
1,2021-06-14,31558,8757451,21283,4603706,8936,3788821,1339,364924,11675,816116,0.093804,19674,4135670,0.475352,13026,4951786,0.569156,8700223
1,2021-06-15,38110,8795561,25023,4628729,11201,3800022,1886,366810,14054,808329,0.092909,23763,4159433,0.478083,15976,4967762,0.570992,8700223
1,2021-06-16,36277,8831838,24544,4653273,9871,3809893,1862,368672,13621,801465,0.09212,22375,4181808,0.480655,15511,4983273,0.572775,8700223
1,2021-06-17,34176,8866014,22592,4675865,9604,3819497,1980,370652,13261,796067,0.0915,20677,4202485,0.483032,15279,4998552,0.574531,8700223
1,2021-06-18,40159,8906173,26088,4701953,11182,3830679,2889,373541,15490,790038,0.090807,24420,4226905,0.485839,18391,5016943,0.576645,8700223
1,2021-06-19,24241,8930414,16829,4718782,6205,3836884,1207,374748,9834,786827,0.090438,14272,4241177,0.487479,11061,5028004,0.577917,8700223
1,2021-06-20,8224,8938638,6019,4724801,1924,3838808,281,375029,3223,785414,0.090275,4926,4246103,0.488045,3513,5031517,0.57832,8700223
1,2021-06-21,21258,8959896,12032,4736833,7022,3845830,2204,377233,10980,788464,0.090626,10144,4256247,0.489211,13194,5044711,0.579837,8700223
1,2021-06-22,31236,8991132,20398,4757231,8662,3854492,2176,379409,12956,785566,0.090293,18052,4274299,0.491286,15154,5059865,0.581579,8700223
1,2021-06-23,29723,9020855,19931,4777162,7953,3862445,1839,381248,12863,783636,0.090071,16628,4290927,0.493197,14698,5074563,0.583268,8700223
1,2021-06-24,28809,9049664,19190,4796352,7929,3870374,1690,382938,12136,781001,0.089768,16482,4307409,0.495092,13847,5088410,0.58486,8700223
1,2021-06-25,32266,9081930,21835,4818187,9000,3879374,1431,384369,14081,778568,0.089488,17958,4325367,0.497156,15525,5103935,0.586644,8700223
1,2021-06-26,22899,9104829,17036,4835223,5009,3884383,854,385223,9903,776486,0.089249,12861,4338228,0.498634,10779,5114714,0.587883,8700223
1,2021-06-27,9335,9114164,6966,4842189,1930,3886313,439,385662,4120,775916,0.089183,5138,4343366,0.499225,4568,5119282,0.588408,8700223
1,2021-06-28,21585,9135749,16046,4858235,4277,3890590,1262,386924,9948,775730,0.089162,11413,4354779,0.500536,11227,5130509,0.589699,8700223
1,2021-06-29,27429,9163178,18793,4877028,7234,3897824,1402,388326,12128,774166,0.088982,15117,4369896,0.502274,13553,5144062,0.591256,8700223
1,2021-06-30,26816,9189994,18593,4895621,7142,3904966,1081,389407,12741,774185,0.088985,13824,4383720,0.503863,13843,5157905,0.592847,8700223
1,2021-07-01,24508,9214502,17011,4912632,6182,3911148,1315,390722,11317,773858,0.088947,12981,4396701,0.505355,12654,5170559,0.594302,8700223
1,2021-07-02,27463,9241965,18867,4931499,7527,3918675,1069,391791,12778,773264,0.088879,14468,4411169,0.507018,13874,5184433,0.595897,8700223
1,2021-07-03,15160,9257125,10609,4942108,4093,3922768,458,392249,7185,773103,0.08886,7818,4418987,0.507917,7657,5192090,0.596777,8700223
1,2021-07-04,1313,9258438,739,4942847,506,3923274,68,392317,637,773143,0.088865,665,4419652,0.507993,705,5192795,0.596858,8700223
1,2021-07-05,11362,9269800,7867,4950714,3127,3926401,368,392685,5372,772994,0.088848,5907,4425559,0.508672,5758,5198553,0.59752,8700223
1,2021-07-06,28070,9297870,19853,4970567,7056,3933457,1161,393846,11172,768684,0.088352,16693,4442252,0.510591,12383,5210936,0.598943,8700223
1,2021-07-07,24638,9322508,17202,4987769,6165,3939622,1271,395117,10494,766531,0.088105,13954,4456206,0.512194,11801,5222737,0.600299,8700223
1,2021-07-08,23498,9346006,16256,5004025,6132,3945754,1110,396227,10087,764562,0.087878,13207,4469413,0.513712,11238,5233975,0.601591,8700223
1,2021-07-09,27815,9373821,19672,5023697,6957,3952711,1186,397413,12530,763177,0.087719,15118,4484531,0.51545,13733,5247708,0.603169,8700223
1,2021-07-10,18345,9392166,13259,5036956,4304,3957015,782,398195,8159,762098,0.087595,10033,4494564,0.516603,8954,5256662,0.604199,8700223
1,2021-07-11,6882,9399048,5023,5041979,1651,3958666,208,398403,3305,762088,0.087594,3529,4498093,0.517009,3519,5260181,0.604603,8700223
1,2021-07-12,20632,9419680,14818,5056797,4899,3963565,915,399318,9112,760786,0.087444,11360,4509453,0.518315,10058,5270239,0.605759,8700223
1,2021-07-13,22904,9442584,15992,5072789,6081,3969646,831,400149,10701,760312,0.08739,12045,4521498,0.519699,11571,5281810,0.607089,8700223
1,2021-07-14,22846,9465430,15711,5088500,6135,3975781,1000,401149,10272,759195,0.087262,12417,4533915,0.521126,11300,5293110,0.608388,8700223
1,2021-07-15,22371,9487801,15822,5104322,5800,3981581,749,401898,10814,759399,0.087285,11398,4545313,0.522436,11602,5304712,0.609721,8700223
1,2021-07-16,27498,9515299,19226,5123548,7257,3988838,1015,402913,13603,760330,0.087392,13717,4559030,0.524013,14648,5319360,0.611405,8700223
1,2021-07-17,18990,9534289,13738,5137286,4540,3993378,712,403625,9333,760862,0.087453,9522,4568552,0.525107,10054,5329414,0.612561,8700223
1,2021-07-18,7572,9541861,5590,5142876,1695,3995073,287,403912,3844,761329,0.087507,3670,4572222,0.525529,4137,5333551,0.613036,8700223
1,2021-07-19,21241,9563102,15384,5158260,5011,4000084,846,404758,10606,762313,0.08762,10492,4582714,0.526735,11476,5345027,0.614355,8700223
1,2021-07-20,25442,9588544,17590,5175850,6944,4007028,908,405666,13059,764104,0.087826,12206,4594920,0.528138,13997,5359024,0.615964,8700223
1,2021-07-21,25752,9614296,18083,5193933,6437,4013465,1232,406898,13107,766023,0.088046,12458,4607378,0.52957,14377,5373401,0.617616,8700223
1,2021-07-22,24901,9639197,17603,5211536,6441,4019906,857,407755,13518,769281,0.088421,11148,4618526,0.530851,14406,5387807,0.619272,8700223
1,2021-07-23,29668,9668865,20978,5232514,7647,4027553,1043,408798,16500,773885,0.08895,12957,4631483,0.532341,17561,5405368,0.621291,8700223
1,2021-07-24,18463,9687328,13046,5245560,4838,4032391,579,409377,10827,777784,0.089398,7519,4639002,0.533205,11418,5416786,0.622603,8700223
1,2021-07-25,7614,9694942,5467,5251027,2029,4034420,118,409495,5639,781637,0.089841,1915,4640917,0.533425,5768,5422554,0.623266,8700223
1,2021-07-26,21922,9716864,15155,5266182,5996,4040416,771,410266,14106,788914,0.090677,7623,4648540,0.534301,14900,5437454,0.624979,8700223
1,2021-07-27,27622,9744486,19741,5285923,6918,4047334,963,411229,16228,794955,0.091372,11158,4659698,0.535584,17199,5454653,0.626956,8700223
1,2021-07-28,28728,9773214,20272,5306195,7454,4054788,1002,412231,17512,802518,0.092241,10970,4670668,0.536845,18533,5473186,0.629086,8700223
1,2021-07-29,27269,9800483,19306,5325501,7147,4061935,816,413047,17011,810308,0.093136,10056,4680724,0.538,17846,5491032,0.631137,8700223
1,2021-07-30,31755,9832238,22702,5348203,8125,4070060,928,413975,19346,818432,0.09407,12154,4692878,0.539397,20278,5511310,0.633468,8700223
1,2021-07-31,20266,9852504,14724,5362927,4993,4075053,549,414524,12523,823979,0.094708,7529,4700407,0.540263,13076,5524386,0.634971,8700223
1,2021-08-01,9048,9861552,6815,5369742,2101,4077154,132,414656,6167,827478,0.09511,2814,4703221,0.540586,6313,5530699,0.635696,8700223
1,2021-08-02,25520,9887072,19006,5388748,5784,4082938,730,415386,16578,836048,0.096095,8746,4711967,0.541592,17316,5548015,0.637687,8700223
1,2021-08-03,29316,9916388,21243,5409991,7107,4090045,966,416352,18354,844652,0.097084,10732,4722699,0.542825,19336,5567351,0.639909,8700223
1,2021-08-04,28350,9944738,20650,5430641,6803,4096848,897,417249,17983,853433,0.098093,10116,4732815,0.543988,18897,5586248,0.642081,8700223
1,2021-08-05,28139,9972877,20638,5451279,6573,4103421,928,418177,17772,862008,0.099079,10114,4742929,0.54515,18689,5604937,0.644229,8700223
1,2021-08-06,34675,10007552,25589,5476868,8084,4111505,1002,419179,21609,871873,0.100213,12764,4755693,0.546617,22629,5627566,0.64683,8700223
1,2021-08-07,22178,10029730,16646,5493514,4954,4116459,578,419757,13788,878003,0.100917,8240,4763933,0.547564,14370,5641936,0.648482,8700223
1,2021-08-08,10637,10040367,7761,5501275,2674,4119133,202,419959,6876,881416,0.10131,3668,4767601,0.547986,7081,5649017,0.649296,8700223
1,2021-08-09,28480,10068847,21359,5522634,6286,4125419,835,420794,17565,889153,0.102199,10674,4778275,0.549213,18411,5667428,0.651412,8700223
1,2021-08-10,30095,10098942,22169,5544803,7037,4132456,889,421683,17953,896135,0.103001,11879,4790154,0.550578,18861,5686289,0.65358,8700223
1,2021-08-11,28355,10127297,20945,5565748,6469,4138925,941,422624,16481,901932,0.103668,11626,4801780,0.551915,17423,5703712,0.655582,8700223
1,2021-08-12,29288,10156585,21028,5586776,7191,4146116,1069,423693,17393,908842,0.104462,11557,4813337,0.553243,18467,5722179,0.657705,8700223
1,2021-08-13,37162,10193747,26999,5613775,9029,4155145,1134,424827,21634,916495,0.105342,15131,4828468,0.554982,22784,5744963,0.660324,8700223
1,2021-08-14,24453,10218200,18586,5632361,5297,4160442,570,425397,14011,921138,0.105875,9944,4838412,0.556125,14587,5759550,0.662,8700223
1,2021-08-15,11443,10229643,8342,5640703,2935,4163377,166,425563,6557,923348,0.106129,4520,4842932,0.556645,6730,5766280,0.662774,8700223
1,2021-08-16,29752,10259395,21153,5661856,7800,4171177,799,426362,16406,928199,0.106687,12367,4855299,0.558066,17218,5783498,0.664753,8700223
1,2021-08-17,32447,10291842,23039,5684895,8444,4179621,964,427326,17013,931799,0.107101,14384,4869683,0.559719,17984,5801482,0.66682,8700223
1,2021-08-18,32583,10324425,23396,5708291,8264,4187885,923,428249,16582,934679,0.107432,14643,4884326,0.561402,17523,5819005,0.668834,8700223
1,2021-08-19,31881,10356306,22727,5731018,8106,4195991,1048,429297,16258,937783,0.107788,14216,4898542,0.563036,17320,5836325,0.670825,8700223
1,2021-08-20,39222,10395528,28454,5759472,9767,4205758,1001,430298,19933,941159,0.108176,17577,4916119,0.565057,20953,5857278,0.673233,8700223
1,2021-08-21,23688,10419216,17756,5777228,5352,4211110,580,430878,11606,942085,0.108283,11267,4927386,0.566352,12193,5869471,0.674635,8700223
1,2021-08-22,12067,10431283,8843,5786071,3022,4214132,202,431080,6026,942713,0.108355,5610,4932996,0.566997,6238,5875709,0.675352,8700223
1,2021-08-23,31964,10463247,23726,5809797,7440,4221572,798,431878,15335,943518,0.108448,15340,4948336,0.56876,16145,5891854,0.677207,8700223
1,2021-08-24,32562,10495809,24690,5834487,7019,4228591,853,432731,15411,943944,0.108497,15855,4964191,0.570582,16281,5908135,0.679079,8700223
1,2021-08-25,32387,10528196,24599,5859086,7007,4235598,781,433512,15086,943849,0.108486,15968,4980159,0.572417,15873,5924008,0.680903,8700223
1,2021-08-26,32392,10560588,24138,5883224,7317,4242915,937,434449,15268,944521,0.108563,15542,4995701,0.574204,16214,5940222,0.682767,8700223
1,2021-08-27,40162,10600750,30784,5914008,8504,4251419,874,435323,18223,943587,0.108455,20044,5015745,0.576508,19110,5959332,0.684963,8700223
1,2021-08-28,25788,10626538,20253,5934261,5095,4256514,440,435763,11244,941593,0.108226,13686,5029431,0.578081,11692,5971024,0.686307,8700223
1,2021-08-29,12280,10638818,9237,5943498,2895,4259409,148,435911,5652,941249,0.108187,6152,5035583,0.578788,5808,5976832,0.686975,8700223
1,2021-08-30,29893,10668711,21977,5965475,6956,4266365,960,436871,12879,939468,0.107982,15619,5051202,0.580583,13838,5990670,0.688565,8700223
1,2021-08-31,30139,10698850,22544,5988019,6779,4273144,816,437687,12712,937044,0.107703,15964,5067166,0.582418,13540,6004210,0.690121,8700223
1,2021-09-01,29516,10728366,21826,6009845,6874,4280018,816,438503,13276,936566,0.107649,14585,5081751,0.584094,14107,6018317,0.691743,8700223
1,2021-09-02,28289,10756655,20830,6030675,6708,4286726,751,439254,12265,935183,0.10749,14403,5096154,0.58575,13020,6031337,0.693239,8700223
1,2021-09-03,35492,10792147,26603,6057278,8197,4294923,692,439946,14698,931715,0.107091,18876,5115030,0.587919,15408,6046745,0.69501,8700223
1,2021-09-04,20047,10812194,15490,6072768,4269,4299192,288,440234,8313,929310,0.106815,11019,5126049,0.589186,8614,6055359,0.696,8700223
1,2021-09-05,11028,10823222,8236,6081004,2716,4301908,76,440310,5009,928807,0.106757,5593,5131642,0.589829,5090,6060449,0.696585,8700223
1,2021-09-06,6703,10829925,4512,6085516,2125,4304033,66,440376,2850,928120,0.106678,3608,5135250,0.590243,2921,6063370,0.696921,8700223
1,2021-09-07,30267,10860192,22502,6108018,7102,4311135,663,441039,10386,920626,0.105816,18549,5153799,0.592376,11055,6074425,0.698192,8700223
1,2021-09-08,28275,10888467,20939,6128957,6705,4317840,631,441670,11481,917442,0.10545,15297,5169096,0.594134,12113,6086538,0.699584,8700223
1,2021-09-09,27867,10916334,20452,6149409,6736,4324576,679,442349,11416,914576,0.105121,14964,5184060,0.595854,12098,6098636,0.700975,8700223
1,2021-09-10,34003,10950337,24873,6174282,8347,4332923,783,443132,13269,909593,0.104548,19041,5203101,0.598042,14058,6112694,0.70259,8700223
1,2021-09-11,20648,10970985,15711,6189993,4557,4337480,380,443512,7994,905999,0.104135,11976,5215077,0.599419,8382,6121076,0.703554,8700223
1,2021-09-12,10601,10981586,7703,6197696,2764,4340244,134,443646,4305,904464,0.103959,5979,5221056,0.600106,4444,6125520,0.704065,8700223
1,2021-09-13,26189,11007775,18768,6216464,6857,4347101,564,444210,10247,900503,0.103503,14787,5235843,0.601806,10826,6136346,0.705309,8700223
1,2021-09-14,25597,11033372,18614,6235078,6348,4353449,635,444845,9766,896210,0.10301,14700,5250543,0.603495,10407,6146753,0.706505,8700223
1,2021-09-15,25294,11058666,18297,6253375,6256,4359705,741,445586,9658,892095,0.102537,14529,5265072,0.605165,10414,6157167,0.707702,8700223
1,2021-09-16,26751,11085417,19416,6272791,6592,4366297,743,446329,10150,887638,0.102025,15328,5280400,0.606927,10871,6168038,0.708952,8700223
1,2021-09-17,30044,11115461,22150,6294941,7171,4373468,723,447052,10940,881640,0.101335,17673,5298073,0.608958,11675,6179713,0.710294,8700223
1,2021-09-18,19005,11134466,14616,6309557,4008,4377476,381,447433,7236,878209,0.100941,11061,5309134,0.61023,7630,6187343,0.711171,8700223
1,2021-09-19,9721,11144187,7147,6316704,2427,4379903,147,447580,3803,876599,0.100756,5567,5314701,0.61087,3957,6191300,0.711625,8700223
1,2021-09-20,24921,11169108,18021,6334725,6200,4386103,700,448280,9596,872935,0.100335,13968,5328669,0.612475,10304,6201604,0.71281,8700223
1,2021-09-21,23403,11192511,17541,6352266,5212,4391315,650,448930,9242,870072,0.100006,12745,5341414,0.61394,9882,6211486,0.713946,8700223
1,2021-09-22,23114,11215625,17319,6369585,5287,4396602,508,449438,9130,867120,0.099666,12609,5354023,0.615389,9657,6221143,0.715056,8700223
1,2021-09-23,22016,11237641,16229,6385814,5280,4401882,507,449945,8619,864704,0.099389,11537,5365560,0.616715,9121,6230264,0.716104,8700223
1,2021-09-24,28421,11266062,21877,6407691,5831,4407713,713,450658,10285,861197,0.098986,14521,5380081,0.618384,11014,6241278,0.71737,8700223
1,2021-09-25,17644,11283706,14225,6421916,3106,4410819,313,450971,6284,859721,0.098816,8077,5388158,0.619313,6601,6247879,0.718129,8700223
1,2021-09-26,8308,11292014,6917,6428833,1330,4412149,61,451032,2760,858434,0.098668,4108,5392266,0.619785,2821,6250700,0.718453,8700223
1,2021-09-27,22826,11314840,17545,6446378,4777,4416926,504,451536,8218,859685,0.098812,7480,5399746,0.620645,8731,6259431,0.719456,8700223
1,2021-09-28,26914,11341754,21848,6468226,4495,4421421,571,452107,9284,859513,0.098792,10038,5409784,0.621798,9866,6269297,0.72059,8700223
1,2021-09-29,26709,11368463,21492,6489718,4606,4426027,611,452718,8528,857693,0.098583,10964,5420748,0.623059,9144,6278441,0.721641,8700223
1,2021-09-30,27993,11396456,22809,6512527,4551,4430578,633,453351,8717,855959,0.098384,11092,5431840,0.624333,9358,6287799,0.722717,8700223
1,2021-10-01,29216,11425672,23803,6536330,4783,4435361,630,453981,9262,854073,0.098167,11782,5443622,0.625688,9896,6297695,0.723854,8700223
1,2021-10-02,16185,11441857,13358,6549688,2532,4437893,295,454276,5874,853361,0.098085,6885,5450507,0.626479,6173,6303868,0.724564,8700223
1,2021-10-03,4525,11446382,3377,6553065,1071,4438964,77,454353,1742,853216,0.098068,1968,5452475,0.626705,1823,6305691,0.724773,8700223
2,2020-08-01,4,4,3,3,1,1,0,0,3,3,0.0,1,1,0.0,4,4,0.0,8407551
2,2020-08-02,2,6,1,4,1,2,0,0,2,5,1e-06,0,1,0.0,2,6,1e-06,8407551
2,2020-08-03,2,8,0,4,2,4,0,0,2,7,1e-06,0,1,0.0,2,8,1e-06,8407551
2,2020-08-04,1,9,0,4,1,5,0,0,1,8,1e-06,0,1,0.0,1,9,1e-06,8407551
2,2020-08-05,8,17,1,5,7,12,0,0,8,16,2e-06,0,1,0.0,8,17,2e-06,8407551
2,2020-08-06,3,20,0,5,3,15,0,0,3,19,2e-06,0,1,0.0,3,20,2e-06,8407551
2,2020-08-07,1,21,1,6,0,15,0,0,1,20,2e-06,0,1,0.0,1,21,2e-06,8407551
2,2020-08-09,2,23,1,7,1,16,0,0,2,22,3e-06,0,1,0.0,2,23,3e-06,8407551
2,2020-08-10,8,31,1,8,7,23,0,0,8,30,4e-06,0,1,0.0,8,31,4e-06,8407551
2,2020-08-11,5,36,1,9,4,27,0,0,5,35,4e-06,0,1,0.0,5,36,4e-06,8407551
2,2020-08-12,10,46,7,16,3,30,0,0,10,45,5e-06,0,1,0.0,10,46,5e-06,8407551
2,2020-08-13,10,56,5,21,5,35,0,0,10,55,7e-06,0,1,0.0,10,56,7e-06,8407551
2,2020-08-14,10,66,3,24,7,42,0,0,10,65,8e-06,0,1,0.0,10,66,8e-06,8407551
2,2020-08-16,1,67,1,25,0,42,0,0,1,66,8e-06,0,1,0.0,1,67,8e-06,8407551
2,2020-08-17,10,77,5,30,5,47,0,0,10,76,9e-06,0,1,0.0,10,77,9e-06,8407551
2,2020-08-18,8,85,5,35,3,50,0,0,8,84,1e-05,0,1,0.0,8,85,1e-05,8407551
2,2020-08-19,10,95,4,39,6,56,0,0,10,94,1.1e-05,0,1,0.0,10,95,1.1e-05,8407551
2,2020-08-20,9,104,5,44,4,60,0,0,9,103,1.2e-05,0,1,0.0,9,104,1.2e-05,8407551
2,2020-08-21,10,114,1,45,9,69,0,0,10,113,1.3e-05,0,1,0.0,10,114,1.4e-05,8407551
2,2020-08-22,6,120,2,47,4,73,0,0,6,119,1.4e-05,0,1,0.0,6,120,1.4e-05,8407551
2,2020-08-23,1,121,1,48,0,73,0,0,0,118,1.4e-05,1,2,0.0,0,120,1.4e-05,8407551
2,2020-08-24,8,129,2,50,6,79,0,0,8,126,1.5e-05,0,2,0.0,8,128,1.5e-05,8407551
2,2020-08-25,14,143,11,61,3,82,0,0,14,140,1.7e-05,0,2,0.0,14,142,1.7e-05,8407551
2,2020-08-26,14,157,11,72,3,85,0,0,14,154,1.8e-05,0,2,0.0,14,156,1.9e-05,8407551
2,2020-08-27,15,172,8,80,7,92,0,0,15,169,2e-05,0,2,0.0,15,171,2e-05,8407551
2,2020-08-28,11,183,3,83,8,100,0,0,10,178,2.1e-05,1,3,0.0,10,181,2.2e-05,8407551
2,2020-08-29,2,185,0,83,2,102,0,0,2,180,2.1e-05,0,3,0.0,2,183,2.2e-05,8407551
2,2020-08-30,1,186,1,84,0,102,0,0,1,181,2.2e-05,0,3,0.0,1,184,2.2e-05,8407551
2,2020-08-31,22,208,8,92,14,116,0,0,17,193,2.3e-05,5,8,1e-06,17,201,2.4e-05,8407551
2,2020-09-01,21,229,18,110,3,119,0,0,19,210,2.5e-05,2,10,1e-06,19,220,2.6e-05,8407551
2,2020-09-02,22,251,17,127,5,124,0,0,16,220,2.6e-05,6,16,2e-06,16,236,2.8e-05,8407551
2,2020-09-03,15,266,5,132,10,134,0,0,13,231,2.7e-05,2,18,2e-06,13,249,3e-05,8407551
2,2020-09-04,16,282,12,144,4,138,0,0,5,225,2.7e-05,11,29,3e-06,5,254,3e-05,8407551
2,2020-09-05,3,285,0,144,3,141,0,0,3,228,2.7e-05,0,29,3e-06,3,257,3.1e-05,8407551
2,2020-09-08,26,311,8,152,18,159,0,0,11,225,2.7e-05,14,43,5e-06,11,268,3.2e-05,8407551
2,2020-09-09,28,339,22,174,6,165,0,0,8,213,2.5e-05,20,63,7e-06,8,276,3.3e-05,8407551
2,2020-09-10,14,353,6,180,8,173,0,0,11,221,2.6e-05,3,66,8e-06,11,287,3.4e-05,8407551
2,2020-09-11,14,367,6,186,8,181,0,0,9,225,2.7e-05,5,71,8e-06,9,296,3.5e-05,8407551
2,2020-09-12,7,374,1,187,6,187,0,0,6,230,2.7e-05,1,72,9e-06,6,302,3.6e-05,8407551
2,2020-09-13,2,376,2,189,0,187,0,0,1,230,2.7e-05,1,73,9e-06,1,303,3.6e-05,8407551
2,2020-09-14,14,390,7,196,7,194,0,0,5,226,2.7e-05,9,82,1e-05,5,308,3.7e-05,8407551
2,2020-09-15,19,409,15,211,4,198,0,0,2,211,2.5e-05,17,99,1.2e-05,2,310,3.7e-05,8407551
2,2020-09-16,21,430,14,225,7,205,0,0,7,204,2.4e-05,14,113,1.3e-05,7,317,3.8e-05,8407551
2,2020-09-17,21,451,6,231,15,220,0,0,8,199,2.4e-05,13,126,1.5e-05,8,325,3.9e-05,8407551
2,2020-09-18,15,466,6,237,9,229,0,0,4,192,2.3e-05,11,137,1.6e-05,4,329,3.9e-05,8407551
2,2020-09-19,2,468,1,238,1,230,0,0,1,192,2.3e-05,1,138,1.6e-05,1,330,3.9e-05,8407551
2,2020-09-21,20,488,12,250,8,238,0,0,5,182,2.2e-05,15,153,1.8e-05,5,335,4e-05,8407551
2,2020-09-22,11,499,5,255,6,244,0,0,2,175,2.1e-05,9,162,1.9e-05,2,337,4e-05,8407551
2,2020-09-23,20,519,17,272,3,247,0,0,4,163,1.9e-05,16,178,2.1e-05,4,341,4.1e-05,8407551
2,2020-09-24,10,529,8,280,2,249,0,0,0,153,1.8e-05,10,188,2.2e-05,0,341,4.1e-05,8407551
2,2020-09-25,17,546,6,286,11,260,0,0,3,142,1.7e-05,14,202,2.4e-05,3,344,4.1e-05,8407551
2,2020-09-26,3,549,2,288,1,261,0,0,0,139,1.7e-05,3,205,2.4e-05,0,344,4.1e-05,8407551
2,2020-09-28,17,566,3,291,14,275,0,0,0,124,1.5e-05,16,221,2.6e-05,1,345,4.1e-05,8407551
2,2020-09-29,13,579,9,300,4,279,0,0,2,116,1.4e-05,10,231,2.7e-05,2,347,4.1e-05,8407551
2,2020-09-30,8,587,3,303,5,284,0,0,1,110,1.3e-05,7,238,2.8e-05,1,348,4.1e-05,8407551
2,2020-10-01,7,594,4,307,3,287,0,0,4,111,1.3e-05,3,241,2.9e-05,4,352,4.2e-05,8407551
2,2020-10-02,7,601,4,311,3,290,0,0,2,108,1.3e-05,5,246,2.9e-05,2,354,4.2e-05,8407551
2,2020-10-05,8,609,6,317,2,292,0,0,1,102,1.2e-05,7,253,3e-05,1,355,4.2e-05,8407551
2,2020-10-06,2,611,1,318,1,293,0,0,0,100,1.2e-05,2,255,3e-05,0,355,4.2e-05,8407551
2,2020-10-07,13,624,5,323,7,300,1,1,2,93,1.1e-05,10,265,3.2e-05,3,358,4.3e-05,8407551
2,2020-10-08,6,630,5,328,1,301,0,1,3,93,1.1e-05,3,268,3.2e-05,3,361,4.3e-05,8407551
2,2020-10-09,15,645,4,332,11,312,0,1,3,85,1e-05,11,279,3.3e-05,3,364,4.3e-05,8407551
2,2020-10-10,7,652,3,335,2,314,2,3,3,86,1e-05,4,283,3.4e-05,5,369,4.4e-05,8407551
2,2020-10-12,6,658,4,339,2,316,0,3,1,82,1e-05,5,288,3.4e-05,1,370,4.4e-05,8407551
2,2020-10-13,3,661,2,341,1,317,0,3,0,79,9e-06,3,291,3.5e-05,0,370,4.4e-05,8407551
2,2020-10-14,9,670,2,343,7,324,0,3,1,72,9e-06,8,299,3.6e-05,1,371,4.4e-05,8407551
2,2020-10-15,4,674,1,344,3,327,0,3,2,72,9e-06,2,301,3.6e-05,2,373,4.4e-05,8407551
2,2020-10-16,6,680,2,346,3,330,1,4,1,69,8e-06,5,306,3.6e-05,2,375,4.5e-05,8407551
2,2020-10-17,2,682,1,347,1,331,0,4,1,69,8e-06,1,307,3.7e-05,1,376,4.5e-05,8407551
2,2020-10-18,1,683,1,348,0,331,0,4,1,70,8e-06,0,307,3.7e-05,1,377,4.5e-05,8407551
2,2020-10-19,11,694,11,359,0,331,0,4,11,81,1e-05,0,307,3.7e-05,11,388,4.6e-05,8407551
2,2020-10-20,1,695,1,360,0,331,0,4,1,82,1e-05,0,307,3.7e-05,1,389,4.6e-05,8407551
2,2020-10-21,4,699,2,362,2,333,0,4,4,86,1e-05,0,307,3.7e-05,4,393,4.7e-05,8407551
2,2020-10-22,1,700,0,362,1,334,0,4,1,87,1e-05,0,307,3.7e-05,1,394,4.7e-05,8407551
2,2020-10-23,4,704,4,366,0,334,0,4,3,89,1.1e-05,1,308,3.7e-05,3,397,4.7e-05,8407551
2,2020-10-24,1,705,1,367,0,334,0,4,1,90,1.1e-05,0,308,3.7e-05,1,398,4.7e-05,8407551
2,2020-10-25,1,706,1,368,0,334,0,4,1,91,1.1e-05,0,308,3.7e-05,1,399,4.7e-05,8407551
2,2020-10-26,3,709,3,371,0,334,0,4,2,92,1.1e-05,1,309,3.7e-05,2,401,4.8e-05,8407551
2,2020-10-27,2,711,0,371,1,335,1,5,0,91,1.1e-05,2,311,3.7e-05,1,402,4.8e-05,8407551
2,2020-10-28,1,712,0,371,1,336,0,5,0,90,1.1e-05,1,312,3.7e-05,0,402,4.8e-05,8407551
2,2020-10-29,1,713,0,371,1,337,0,5,0,89,1.1e-05,1,313,3.7e-05,0,402,4.8e-05,8407551
2,2020-10-30,5,718,2,373,3,340,0,5,1,86,1e-05,4,317,3.8e-05,1,403,4.8e-05,8407551
2,2020-11-01,8,726,2,375,3,343,3,8,3,87,1e-05,5,322,3.8e-05,6,409,4.9e-05,8407551
2,2020-11-02,4,730,4,379,0,343,0,8,1,85,1e-05,3,325,3.9e-05,1,410,4.9e-05,8407551
2,2020-11-03,4,734,0,379,2,345,2,10,1,85,1e-05,3,328,3.9e-05,3,413,4.9e-05,8407551
2,2020-11-04,3,737,0,379,0,345,3,13,0,85,1e-05,3,331,3.9e-05,3,416,4.9e-05,8407551
2,2020-11-05,3,740,2,381,1,346,0,13,1,84,1e-05,2,333,4e-05,1,417,5e-05,8407551
2,2020-11-06,1,741,1,382,0,346,0,13,1,85,1e-05,0,333,4e-05,1,418,5e-05,8407551
2,2020-11-07,1,742,1,383,0,346,0,13,1,86,1e-05,0,333,4e-05,1,419,5e-05,8407551
2,2020-11-08,1,743,0,383,0,346,1,14,0,86,1e-05,1,334,4e-05,1,420,5e-05,8407551
2,2020-11-09,3,746,2,385,1,347,0,14,0,83,1e-05,3,337,4e-05,0,420,5e-05,8407551
2,2020-11-10,7,753,3,388,1,348,3,17,0,79,9e-06,7,344,4.1e-05,3,423,5e-05,8407551
2,2020-11-11,5,758,5,393,0,348,0,17,1,76,9e-06,4,348,4.1e-05,1,424,5e-05,8407551
2,2020-11-12,2,760,1,394,1,349,0,17,0,74,9e-06,2,350,4.2e-05,0,424,5e-05,8407551
2,2020-11-13,5,765,3,397,0,349,2,19,2,75,9e-06,3,353,4.2e-05,4,428,5.1e-05,8407551
2,2020-11-14,2,767,0,397,0,349,2,21,0,75,9e-06,2,355,4.2e-05,2,430,5.1e-05,8407551
2,2020-11-15,3,770,1,398,0,349,2,23,1,76,9e-06,2,357,4.2e-05,3,433,5.2e-05,8407551
2,2020-11-16,3,773,2,400,1,350,0,23,2,77,9e-06,1,358,4.3e-05,2,435,5.2e-05,8407551
2,2020-11-17,4,777,1,401,1,351,2,25,1,77,9e-06,3,361,4.3e-05,3,438,5.2e-05,8407551
2,2020-11-18,9,786,3,404,2,353,4,29,4,80,1e-05,5,366,4.4e-05,8,446,5.3e-05,8407551
2,2020-11-19,3,789,1,405,1,354,1,30,1,80,1e-05,2,368,4.4e-05,2,448,5.3e-05,8407551
2,2020-11-20,9,798,4,409,1,355,4,34,5,85,1e-05,4,372,4.4e-05,9,457,5.4e-05,8407551
2,2020-11-21,2,800,1,410,0,355,1,35,1,86,1e-05,1,373,4.4e-05,2,459,5.5e-05,8407551
2,2020-11-22,3,803,3,413,0,355,0,35,3,89,1.1e-05,0,373,4.4e-05,3,462,5.5e-05,8407551
2,2020-11-23,7,810,5,418,0,355,2,37,4,92,1.1e-05,3,376,4.5e-05,6,468,5.6e-05,8407551
2,2020-11-24,2,812,0,418,0,355,2,39,0,92,1.1e-05,2,378,4.5e-05,2,470,5.6e-05,8407551
2,2020-11-25,3,815,2,420,1,356,0,39,2,93,1.1e-05,1,379,4.5e-05,2,472,5.6e-05,8407551
2,2020-11-27,3,818,0,420,1,357,2,41,1,94,1.1e-05,2,381,4.5e-05,3,475,5.6e-05,8407551
2,2020-11-28,1,819,0,420,1,358,0,41,1,95,1.1e-05,0,381,4.5e-05,1,476,5.7e-05,8407551
2,2020-11-30,7,826,2,422,2,360,3,44,4,99,1.2e-05,3,384,4.6e-05,7,483,5.7e-05,8407551
2,2020-12-01,79,905,57,479,16,376,6,50,72,169,2e-05,10,394,4.7e-05,80,563,6.7e-05,8407551
2,2020-12-02,24,929,20,499,1,377,3,53,19,187,2.2e-05,5,399,4.7e-05,23,586,7e-05,8407551
2,2020-12-03,17,946,7,506,9,386,1,54,14,200,2.4e-05,2,401,4.8e-05,15,601,7.1e-05,8407551
2,2020-12-04,12,958,5,511,6,392,1,55,9,207,2.5e-05,3,404,4.8e-05,10,611,7.3e-05,8407551
2,2020-12-05,6,964,4,515,1,393,1,56,5,212,2.5e-05,1,405,4.8e-05,6,617,7.3e-05,8407551
2,2020-12-06,8,972,6,521,1,394,1,57,7,219,2.6e-05,1,406,4.8e-05,8,625,7.4e-05,8407551
2,2020-12-07,11,983,7,528,3,397,1,58,9,228,2.7e-05,2,408,4.9e-05,11,636,7.6e-05,8407551
2,2020-12-08,23,1006,10,538,3,400,10,68,12,240,2.9e-05,10,418,5e-05,22,658,7.8e-05,8407551
2,2020-12-09,5,1011,4,542,0,400,1,69,3,242,2.9e-05,2,420,5e-05,4,662,7.9e-05,8407551
2,2020-12-10,12,1023,8,550,0,400,4,73,8,250,3e-05,4,424,5e-05,12,674,8e-05,8407551
2,2020-12-11,15,1038,3,553,2,402,10,83,3,251,3e-05,12,436,5.2e-05,13,687,8.2e-05,8407551
2,2020-12-12,20,1058,13,566,6,408,1,84,19,270,3.2e-05,1,437,5.2e-05,20,707,8.4e-05,8407551
2,2020-12-13,11,1069,8,574,3,411,0,84,10,280,3.3e-05,0,437,5.2e-05,10,717,8.5e-05,8407551
2,2020-12-14,22,1091,13,587,6,417,3,87,19,298,3.5e-05,4,441,5.2e-05,22,739,8.8e-05,8407551
2,2020-12-15,290,1381,274,861,9,426,7,94,277,571,6.8e-05,11,452,5.4e-05,284,1023,0.000122,8407551
2,2020-12-16,2274,3655,2263,3124,8,434,3,97,2254,2819,0.000335,11,463,5.5e-05,2259,3282,0.00039,8407551
2,2020-12-17,7173,10828,7158,10282,9,443,6,103,7115,9923,0.00118,20,483,5.7e-05,7124,10406,0.001238,8407551
2,2020-12-18,11292,22120,11268,21550,24,467,0,103,11227,21132,0.002513,26,509,6.1e-05,11235,21641,0.002574,8407551
2,2020-12-19,5618,27738,5609,27159,9,476,0,103,5597,26717,0.003178,20,529,6.3e-05,5605,27246,0.003241,8407551
2,2020-12-20,4277,32015,4253,31412,24,500,0,103,4254,30962,0.003683,16,545,6.5e-05,4261,31507,0.003747,8407551
2,2020-12-21,12943,44958,12909,44321,34,534,0,103,12817,43748,0.005203,51,596,7.1e-05,12837,44344,0.005274,8407551
2,2020-12-22,12302,57260,11737,56058,565,1099,0,103,12226,55956,0.006655,31,627,7.5e-05,12239,56583,0.00673,8407551
2,2020-12-23,11900,69160,9564,65622,2332,3431,4,107,11828,67755,0.008059,41,668,7.9e-05,11840,68423,0.008138,8407551
2,2020-12-24,5937,75097,3514,69136,2422,5853,1,108,5888,73631,0.008758,17,685,8.1e-05,5893,74316,0.008839,8407551
2,2020-12-25,514,75611,428,69564,86,5939,0,108,511,74138,0.008818,4,689,8.2e-05,511,74827,0.0089,8407551
2,2020-12-26,2652,78263,1692,71256,959,6898,1,109,2633,76756,0.009129,20,709,8.4e-05,2638,77465,0.009214,8407551
2,2020-12-27,2246,80509,1224,72480,1022,7920,0,109,2217,78962,0.009392,15,724,8.6e-05,2221,79686,0.009478,8407551
2,2020-12-28,11300,91809,7308,79788,3990,11910,2,111,11221,90150,0.010723,45,769,9.1e-05,11233,90919,0.010814,8407551
2,2020-12-29,13063,104872,7310,87098,5753,17663,0,111,12994,103110,0.012264,43,812,9.7e-05,13003,103922,0.012361,8407551
2,2020-12-30,15878,120750,8857,95955,7020,24683,1,112,15781,118853,0.014136,50,862,0.000103,15793,119715,0.014239,8407551
2,2020-12-31,7673,128423,2831,98786,4841,29524,1,113,7620,126443,0.015039,40,902,0.000107,7630,127345,0.015147,8407551
2,2021-01-01,1536,129959,742,99528,789,30313,5,118,1486,127897,0.015212,40,942,0.000112,1494,128839,0.015324,8407551
2,2021-01-02,4927,134886,2825,102353,2102,32415,0,118,4897,132773,0.015792,22,964,0.000115,4898,133737,0.015907,8407551
2,2021-01-03,1469,136355,834,103187,634,33049,1,119,1454,134217,0.015964,11,975,0.000116,1455,135192,0.01608,8407551
2,2021-01-04,12627,148982,6377,109564,6247,39296,3,122,11814,145295,0.017281,739,1714,0.000204,11817,147009,0.017485,8407551
2,2021-01-05,14155,163137,7102,116666,7053,46349,0,122,12843,156927,0.018665,1235,2949,0.000351,12867,159876,0.019016,8407551
2,2021-01-06,19314,182451,10607,127273,8706,55055,1,123,15256,168290,0.020017,3903,6852,0.000815,15266,175142,0.020832,8407551
2,2021-01-07,23595,206046,13273,140546,10320,65375,2,125,15655,176086,0.020944,7870,14722,0.001751,15666,190808,0.022695,8407551
2,2021-01-08,27276,233322,16444,156990,10829,76204,3,128,16586,182137,0.021664,10551,25273,0.003006,16602,207410,0.024669,8407551
2,2021-01-09,9939,243261,5784,162774,4154,80358,1,129,6332,184894,0.021991,3580,28853,0.003432,6337,213747,0.025423,8407551
2,2021-01-10,5361,248622,2966,165740,2392,82750,3,132,3116,185762,0.022095,2252,31105,0.0037,3120,216867,0.025794,8407551
2,2021-01-11,26298,274920,18120,183860,8176,90926,2,134,15062,189711,0.022564,11133,42238,0.005024,15082,231949,0.027588,8407551
2,2021-01-12,26783,301703,16635,200495,10148,101074,0,134,16911,196901,0.02342,9777,52015,0.006187,16967,248916,0.029606,8407551
2,2021-01-13,28896,330599,15279,215774,13616,114690,1,135,20794,209704,0.024942,8015,60030,0.00714,20818,269734,0.032082,8407551
2,2021-01-14,31005,361604,11911,227685,19090,133780,4,139,26518,231922,0.027585,4382,64412,0.007661,26600,296334,0.035246,8407551
2,2021-01-15,35501,397105,12900,240585,22598,156378,3,142,32043,260698,0.031008,3357,67769,0.00806,32133,328467,0.039068,8407551
2,2021-01-16,18444,415549,6155,246740,12287,168665,2,144,16992,276242,0.032856,1454,69223,0.008233,16998,345465,0.04109,8407551
2,2021-01-17,10665,426214,3618,250358,7047,175712,0,144,9864,285319,0.033936,794,70017,0.008328,9871,355336,0.042264,8407551
2,2021-01-18,19909,446123,11114,261472,8795,184507,0,144,14937,295437,0.035139,4886,74903,0.008909,15004,370340,0.044048,8407551
2,2021-01-19,33055,479178,17251,278723,15804,200311,0,144,24713,311964,0.037105,8200,83103,0.009884,24727,395067,0.04699,8407551
2,2021-01-20,38053,517231,19147,297870,18905,219216,1,145,29233,332493,0.039547,8731,91834,0.010923,29260,424327,0.05047,8407551
2,2021-01-21,41683,558914,17712,315582,23969,243185,2,147,36808,364714,0.043379,4725,96559,0.011485,36946,461273,0.054864,8407551
2,2021-01-22,39948,598862,16644,332226,23304,266489,0,147,36374,397611,0.047292,3498,100057,0.011901,36395,497668,0.059193,8407551
2,2021-01-23,24551,623413,10899,343125,13649,280138,3,150,21489,416116,0.049493,3011,103068,0.012259,21516,519184,0.061752,8407551
2,2021-01-24,12548,635961,6149,349274,6399,286537,0,150,11557,426726,0.050755,962,104030,0.012373,11572,530756,0.063128,8407551
2,2021-01-25,34296,670257,15704,364978,18590,305127,2,152,25140,443017,0.052693,8968,112998,0.01344,25259,556015,0.066133,8407551
2,2021-01-26,40705,710962,19840,384818,20863,325990,2,154,31136,464744,0.055277,9457,122455,0.014565,31184,587199,0.069842,8407551
2,2021-01-27,45913,756875,22577,407395,23335,349325,1,155,35165,489468,0.058218,10466,132921,0.01581,35190,622389,0.074027,8407551
2,2021-01-28,48497,805372,22493,429888,26002,375327,2,157,39409,520017,0.061851,8925,141846,0.016871,39474,661863,0.078722,8407551
2,2021-01-29,46114,851486,22070,451958,24042,399369,2,159,37033,548219,0.065206,8907,150753,0.017931,37109,698972,0.083136,8407551
2,2021-01-30,31437,882923,13229,465187,18208,417577,0,159,27901,572713,0.068119,3442,154195,0.01834,27936,726908,0.086459,8407551
2,2021-01-31,17199,900122,10095,475282,7103,424680,1,160,15924,587382,0.069864,1272,155467,0.018491,15941,742849,0.088355,8407551
2,2021-02-01,41753,941875,19920,495202,21821,446501,12,172,30354,606457,0.072132,11321,166788,0.019838,30396,773245,0.09197,8407551
2,2021-02-02,48472,990347,19687,514889,28782,475283,3,175,36476,631199,0.075075,11766,178554,0.021237,36508,809753,0.096313,8407551
2,2021-02-03,54563,1044910,23926,538815,30635,505918,2,177,39675,656373,0.078069,14569,193123,0.02297,39743,849496,0.10104,8407551
2,2021-02-04,56810,1101720,24286,563101,32520,538438,4,181,40989,681792,0.081093,15622,208745,0.024828,41041,890537,0.105921,8407551
2,2021-02-05,61040,1162760,26278,589379,34754,573192,8,189,40900,703047,0.083621,19752,228497,0.027178,41007,931544,0.110798,8407551
2,2021-02-06,39761,1202521,18225,607604,21533,594725,3,192,31388,726374,0.086395,8102,236599,0.028141,31429,962973,0.114537,8407551
2,2021-02-07,15807,1218328,10320,617924,5485,600210,2,194,11827,734315,0.08734,3907,240506,0.028606,11848,974821,0.115946,8407551
2,2021-02-08,43385,1261713,21773,639697,21610,621820,2,196,29406,750054,0.089212,13750,254256,0.030241,29489,1004310,0.119453,8407551
2,2021-02-09,49949,1311662,23501,663198,26446,648266,2,198,30539,761578,0.090583,19109,273365,0.032514,30633,1034943,0.123097,8407551
2,2021-02-10,60149,1371811,28031,691229,32115,680381,3,201,34294,770617,0.091658,25381,298746,0.035533,34420,1069363,0.127191,8407551
2,2021-02-11,64914,1436725,29694,720923,35212,715593,8,209,35686,777759,0.092507,28680,327426,0.038944,35822,1105185,0.131451,8407551
2,2021-02-12,66481,1503206,28560,749483,37917,753510,4,213,35204,782328,0.093051,30818,358244,0.04261,35387,1140572,0.13566,8407551
2,2021-02-13,38459,1541665,15926,765409,22532,776042,1,214,21952,788082,0.093735,16315,374559,0.04455,22069,1162641,0.138285,8407551
2,2021-02-14,20301,1561966,9438,774847,10861,786903,2,216,11187,790343,0.094004,9012,383571,0.045622,11273,1173914,0.139626,8407551
2,2021-02-15,33500,1595466,14978,789825,18519,805422,3,219,18372,794056,0.094446,14856,398427,0.047389,18569,1192483,0.141835,8407551
2,2021-02-16,56778,1652244,27640,817465,29134,834556,4,223,29589,796932,0.094788,26947,425374,0.050594,29823,1222306,0.145382,8407551
2,2021-02-17,62144,1714388,31765,849230,30369,864925,10,233,30469,796110,0.09469,31422,456796,0.054332,30600,1252906,0.149022,8407551
2,2021-02-18,66944,1781332,33554,882784,33384,898309,6,239,32226,794320,0.094477,34233,491029,0.058403,32443,1285349,0.15288,8407551
2,2021-02-19,60195,1841527,33123,915907,27067,925376,5,244,29536,793679,0.094401,30323,521352,0.06201,29682,1315031,0.156411,8407551
2,2021-02-20,38032,1879559,24568,940475,13462,938838,2,246,20494,796977,0.094793,17355,538707,0.064074,20653,1335684,0.158867,8407551
2,2021-02-21,21944,1901503,17658,958133,4280,943118,6,252,10643,796683,0.094758,11113,549820,0.065396,10819,1346503,0.160154,8407551
2,2021-02-22,39889,1941392,27167,985300,12716,955834,6,258,18808,794829,0.094538,20832,570652,0.067874,18978,1365481,0.162411,8407551
2,2021-02-23,54396,1995788,27729,1013029,26660,982494,7,265,23396,788074,0.093734,30572,601224,0.07151,23817,1389298,0.165244,8407551
2,2021-02-24,71775,2067563,36828,1049857,34943,1017437,4,269,32576,782269,0.093044,38806,640030,0.076126,33001,1422299,0.169169,8407551
2,2021-02-25,77907,2145470,36761,1086618,41139,1058576,7,276,39133,783575,0.093199,38291,678321,0.08068,39597,1461896,0.173879,8407551
2,2021-02-26,86514,2231984,36996,1123614,49513,1108089,5,281,45903,789794,0.093939,40038,718359,0.085442,46257,1508153,0.179381,8407551
2,2021-02-27,63138,2295122,29226,1152840,33900,1141989,12,293,33964,795263,0.094589,28713,747072,0.088857,34182,1542335,0.183446,8407551
2,2021-02-28,31099,2326221,18562,1171402,12536,1154525,1,294,18031,800626,0.095227,12829,759901,0.090383,18192,1560527,0.18561,8407551
2,2021-03-01,59681,2385902,30910,1202312,28686,1183211,85,379,32594,806976,0.095982,26563,786464,0.093543,32913,1593440,0.189525,8407551
2,2021-03-02,71921,2457823,34489,1236801,37413,1220624,19,398,40073,815959,0.097051,31520,817984,0.097292,40503,1633943,0.194342,8407551
2,2021-03-03,82686,2540509,39811,1276612,42854,1263478,21,419,46362,827045,0.098369,35869,853853,0.101558,46955,1680898,0.199927,8407551
2,2021-03-04,90805,2631314,44554,1321166,46216,1309694,35,454,51527,840325,0.099949,38821,892674,0.106175,52101,1732999,0.206124,8407551
2,2021-03-05,84635,2715949,39624,1360790,44635,1354329,376,830,50705,858445,0.102104,33431,926105,0.110152,51551,1784550,0.212256,8407551
2,2021-03-06,64374,2780323,31292,1392082,31333,1385662,1749,2579,38906,874149,0.103972,25197,951302,0.113149,40901,1825451,0.21712,8407551
2,2021-03-07,29788,2810111,16879,1408961,11310,1396972,1599,4178,18629,883532,0.105088,11008,962310,0.114458,20391,1845842,0.219546,8407551
2,2021-03-08,52110,2862221,23855,1432816,25594,1422566,2661,6839,32433,899402,0.106976,19475,981785,0.116774,35345,1881187,0.22375,8407551
2,2021-03-09,72059,2934280,32718,1465534,35347,1457913,3994,10833,39541,910962,0.10835,32198,1013983,0.120604,43758,1924945,0.228954,8407551
2,2021-03-10,79856,3014136,37658,1503192,35562,1493475,6636,17469,41755,921786,0.109638,37741,1051724,0.125093,48565,1973510,0.234731,8407551
2,2021-03-11,94501,3108637,43474,1546666,42547,1536022,8480,25949,48677,933778,0.111064,45366,1097090,0.130489,57358,2030868,0.241553,8407551
2,2021-03-12,95514,3204151,39336,1586002,44181,1580203,11997,37946,46533,943903,0.112268,48598,1145688,0.136269,58723,2089591,0.248537,8407551
2,2021-03-13,70302,3274453,29201,1615203,33047,1613250,8054,46000,37645,957479,0.113883,32369,1178057,0.140119,45945,2135536,0.254002,8407551
2,2021-03-14,37659,3312112,18529,1633732,14575,1627825,4555,50555,18646,961907,0.11441,18850,1196907,0.142361,23278,2158814,0.256771,8407551
2,2021-03-15,68464,3380576,30836,1664568,32538,1660363,5090,55645,37459,973942,0.115841,30669,1227576,0.146009,42704,2201518,0.26185,8407551
2,2021-03-16,87486,3468062,38767,1703335,44625,1704988,4094,59739,52342,995802,0.118441,34775,1262351,0.150145,56635,2258153,0.268586,8407551
2,2021-03-17,94304,3562366,45158,1748493,44890,1749878,4256,63995,59252,1024825,0.121893,34610,1296961,0.154261,63633,2321786,0.276155,8407551
2,2021-03-18,99253,3661619,47320,1795813,47226,1797104,4707,68702,59762,1050378,0.124933,39020,1335981,0.158903,64573,2386359,0.283835,8407551
2,2021-03-19,98422,3760041,46773,1842586,45528,1842632,6121,74823,57654,1073847,0.127724,40365,1376346,0.163704,63834,2450193,0.291428,8407551
2,2021-03-20,70520,3830561,34082,1876668,32405,1875037,4033,78856,45638,1098995,0.130715,24572,1400918,0.166626,49720,2499913,0.297341,8407551
2,2021-03-21,34029,3864590,21897,1898565,10103,1885140,2029,80885,20234,1107686,0.131749,13611,1414529,0.168245,22302,2522215,0.299994,8407551
2,2021-03-22,63504,3928094,34947,1933512,25918,1911058,2639,83524,41816,1130845,0.134503,21391,1435920,0.170789,44550,2566765,0.305293,8407551
2,2021-03-23,84609,4012703,44953,1978465,36732,1947790,2924,86448,52158,1153892,0.137245,32146,1468066,0.174613,55193,2621958,0.311858,8407551
2,2021-03-24,92831,4105534,49835,2028300,39770,1987560,3226,89674,53870,1172505,0.139459,38589,1506655,0.179203,57202,2679160,0.318661,8407551
2,2021-03-25,102606,4208140,51760,2080060,46899,2034459,3947,93621,57421,1189173,0.141441,44778,1551433,0.184529,61446,2740606,0.32597,8407551
2,2021-03-26,104782,4312922,52076,2132136,49176,2083635,3530,97151,56785,1201915,0.142957,47652,1599085,0.190196,60394,2801000,0.333153,8407551
2,2021-03-27,76450,4389372,38127,2170263,34979,2118614,3344,100495,37967,1205120,0.143338,38196,1637281,0.194739,41401,2842401,0.338077,8407551
2,2021-03-28,38210,4427582,23612,2193875,13777,2132391,821,101316,20193,1208343,0.143721,17855,1655136,0.196863,21078,2863479,0.340584,8407551
2,2021-03-29,72605,4500187,36878,2230753,33448,2165839,2279,103595,40645,1219695,0.145071,31699,1686835,0.200633,43051,2906530,0.345705,8407551
2,2021-03-30,93215,4593402,45698,2276451,43096,2208935,4421,108016,51540,1234319,0.146811,41415,1728250,0.205559,56039,2962569,0.35237,8407551
2,2021-03-31,102409,4695811,52797,2329248,44469,2253404,5143,113159,57569,1252579,0.148983,44515,1772765,0.210854,62775,3025344,0.359837,8407551
2,2021-04-01,118886,4814697,57309,2386557,52181,2305585,9396,122555,63975,1271613,0.151247,54395,1827160,0.217324,73429,3098773,0.36857,8407551
2,2021-04-02,112676,4927373,52053,2438610,50317,2355902,10306,132861,59627,1288995,0.153314,52602,1879762,0.22358,69984,3168757,0.376894,8407551
2,2021-04-03,77206,5004579,37820,2476430,29485,2385387,9901,142762,37851,1297715,0.154351,39065,1918827,0.228227,47785,3216542,0.382578,8407551
2,2021-04-04,29231,5033810,15049,2491479,10280,2395667,3902,146664,12817,1298165,0.154405,16294,1935121,0.230165,16744,3233286,0.384569,8407551
2,2021-04-05,80442,5114252,39321,2530800,32089,2427756,9032,155696,38005,1303066,0.154988,42203,1977324,0.235184,47104,3280390,0.390172,8407551
2,2021-04-06,104816,5219068,50979,2581779,38991,2466747,14846,170542,49059,1311529,0.155994,55460,2032784,0.241781,63923,3344313,0.397775,8407551
2,2021-04-07,111478,5330546,55525,2637304,39497,2506244,16456,186998,51752,1320357,0.157044,59412,2092196,0.248847,68240,3412553,0.405891,8407551
2,2021-04-08,120329,5450875,57788,2695092,43502,2549746,19039,206037,55221,1329933,0.158183,64715,2156911,0.256545,74291,3486844,0.414728,8407551
2,2021-04-09,119776,5570651,57653,2752745,43817,2593563,18306,224343,55954,1340818,0.159478,63426,2220337,0.264088,74311,3561155,0.423566,8407551
2,2021-04-10,88174,5658825,37905,2790650,31757,2625320,18512,242855,36004,1343505,0.159797,51866,2272203,0.270257,54553,3615708,0.430055,8407551
2,2021-04-11,44899,5703724,23303,2813953,13040,2638360,8556,251411,18129,1343667,0.159817,26587,2298790,0.27342,26749,3642457,0.433236,8407551
2,2021-04-12,80929,5784653,37613,2851566,33721,2672081,9595,261006,35622,1343965,0.159852,44985,2343775,0.27877,45283,3687740,0.438622,8407551
2,2021-04-13,102562,5887215,53240,2904806,49052,2721133,270,261276,55691,1353560,0.160993,46482,2390257,0.284299,56077,3743817,0.445292,8407551
2,2021-04-14,107532,5994747,56298,2961104,51169,2772302,65,261341,54337,1355366,0.161208,52796,2443053,0.290578,54602,3798419,0.451787,8407551
2,2021-04-15,113944,6108691,60464,3021568,53380,2825682,100,261441,58860,1359948,0.161753,54547,2497600,0.297066,59129,3857548,0.458819,8407551
2,2021-04-16,111666,6220357,58076,3079644,53526,2879208,64,261505,56306,1361577,0.161947,54903,2552503,0.303596,56532,3914080,0.465543,8407551
2,2021-04-17,83938,6304295,42731,3122375,41190,2920398,17,261522,46648,1371409,0.163116,36955,2589458,0.307992,46787,3960867,0.471108,8407551
2,2021-04-18,36233,6340528,22047,3144422,14174,2934572,12,261534,16989,1369450,0.162883,19062,2608520,0.310259,17103,3977970,0.473143,8407551
2,2021-04-19,75307,6415835,40427,3184849,34859,2969431,21,261555,33801,1362218,0.162023,41147,2649667,0.315153,33915,4011885,0.477176,8407551
2,2021-04-20,97980,6513815,49553,3234402,48394,3017825,33,261588,46641,1358281,0.161555,50724,2700391,0.321186,46787,4058672,0.482741,8407551
2,2021-04-21,104451,6618266,56536,3290938,47845,3065670,70,261658,48848,1352260,0.160839,55073,2755464,0.327737,49052,4107724,0.488576,8407551
2,2021-04-22,109057,6727323,56328,3347266,52700,3118370,29,261687,47374,1338696,0.159225,61143,2816607,0.335009,47579,4155303,0.494235,8407551
2,2021-04-23,108623,6835946,57869,3405135,50732,3169102,22,261709,49753,1330246,0.15822,58396,2875003,0.341955,49946,4205249,0.500175,8407551
2,2021-04-24,81406,6917352,47852,3452987,33509,3202611,45,261754,42063,1333579,0.158617,38900,2913903,0.346582,42233,4247482,0.505198,8407551
2,2021-04-25,36820,6954172,22690,3475677,14113,3216724,17,261771,19891,1336775,0.158997,16772,2930675,0.348577,19968,4267450,0.507573,8407551
2,2021-04-26,74821,7028993,41433,3517110,33066,3249790,322,262093,34147,1331097,0.158322,40334,2971009,0.353374,34656,4302106,0.511695,8407551
2,2021-04-27,88850,7117843,46838,3563948,40609,3290399,1403,263496,37841,1319945,0.156995,50568,3021577,0.359388,39416,4341522,0.516384,8407551
2,2021-04-28,88872,7206715,47433,3611381,39554,3329953,1885,265381,38788,1311138,0.155948,49625,3071202,0.365291,40818,4382340,0.521239,8407551
2,2021-04-29,92109,7298824,50016,3661397,40293,3370246,1800,267181,35423,1292249,0.153701,56213,3127415,0.371977,37324,4419664,0.525678,8407551
2,2021-04-30,95706,7394530,52749,3714146,40885,3411131,2072,269253,36901,1273053,0.151418,58289,3185704,0.37891,39093,4458757,0.530328,8407551
2,2021-05-01,63506,7458036,38523,3752669,23342,3434473,1641,270894,24688,1261061,0.149991,38473,3224177,0.383486,26481,4485238,0.533477,8407551
2,2021-05-02,29611,7487647,20638,3773307,7963,3442436,1010,271904,11157,1254938,0.149263,18319,3242496,0.385665,12196,4497434,0.534928,8407551
2,2021-05-03,61124,7548771,36282,3809589,22756,3465192,2086,273990,20334,1236918,0.14712,40499,3282995,0.390482,22479,4519913,0.537602,8407551
2,2021-05-04,80478,7629249,48023,3857612,30035,3495227,2420,276410,25872,1211076,0.144046,54229,3337224,0.396932,28387,4548300,0.540978,8407551
2,2021-05-05,81209,7710458,48292,3905904,30546,3525773,2371,278781,25134,1183015,0.140709,55659,3392883,0.403552,27598,4575898,0.544261,8407551
2,2021-05-06,83590,7794048,50732,3956636,29912,3555685,2946,281727,25124,1153215,0.137164,57981,3450864,0.410448,28181,4604079,0.547612,8407551
2,2021-05-07,84444,7878492,48791,4005427,33206,3588891,2447,284174,25614,1123038,0.133575,58409,3509273,0.417395,28232,4632311,0.55097,8407551
2,2021-05-08,56172,7934664,34037,4039464,20405,3609296,1730,285904,17368,1103855,0.131293,38574,3547847,0.421983,19391,4651702,0.553277,8407551
2,2021-05-09,22129,7956793,15942,4055406,5432,3614728,755,286659,6260,1095184,0.130262,15757,3563604,0.423858,7086,4658788,0.55412,8407551
2,2021-05-10,50736,8007529,27703,4083109,21125,3635853,1908,288567,14063,1075041,0.127866,36383,3599987,0.428185,16240,4675028,0.556051,8407551
2,2021-05-11,66840,8074369,36201,4119310,28468,3664321,2171,290738,19870,1050694,0.12497,46620,3646607,0.43373,22273,4697301,0.5587,8407551
2,2021-05-12,65730,8140099,35005,4154315,28469,3692790,2256,292994,19149,1025986,0.122031,46269,3692876,0.439233,21561,4718862,0.561265,8407551
2,2021-05-13,71580,8211679,41550,4195865,28058,3720848,1972,294966,25997,1008822,0.11999,45268,3738144,0.444617,28104,4746966,0.564607,8407551
2,2021-05-14,80842,8292521,48400,4244265,30129,3750977,2313,297279,30859,992621,0.118063,49601,3787745,0.450517,33400,4780366,0.56858,8407551
2,2021-05-15,67211,8359732,44116,4288381,21343,3772320,1752,299031,25858,979414,0.116492,41009,3828754,0.455395,27802,4808168,0.571887,8407551
2,2021-05-16,32065,8391797,23976,4312357,7151,3779471,938,299969,12900,974300,0.115884,18999,3847753,0.457654,13885,4822053,0.573538,8407551
2,2021-05-17,58791,8450588,37183,4349540,19631,3799102,1977,301946,22928,963752,0.114629,35611,3883364,0.46189,25063,4847116,0.576519,8407551
2,2021-05-18,70934,8521522,41444,4390984,27494,3826596,1996,303942,27958,951266,0.113144,42650,3926014,0.466963,30164,4877280,0.580107,8407551
2,2021-05-19,69616,8591138,41157,4432141,26369,3852965,2090,306032,27321,938965,0.111681,41919,3967933,0.471949,29618,4906898,0.58363,8407551
2,2021-05-20,70358,8661496,40802,4472943,27336,3880301,2220,308252,26573,924655,0.109979,43384,4011317,0.477109,29074,4935972,0.587088,8407551
2,2021-05-21,74135,8735631,43658,4516601,28280,3908581,2197,310449,27957,909274,0.10815,45783,4057100,0.482554,30402,4966374,0.590704,8407551
2,2021-05-22,54198,8789829,34420,4551021,17995,3926576,1783,312232,22425,902236,0.107313,31501,4088601,0.486301,24463,4990837,0.593614,8407551
2,2021-05-23,24678,8814507,16872,4567893,7075,3933651,731,312963,10284,899040,0.106932,14267,4102868,0.487998,11071,5001908,0.59493,8407551
2,2021-05-24,45520,8860027,25897,4593790,17822,3951473,1801,314764,17376,890508,0.105918,27895,4130763,0.491316,19363,5021271,0.597233,8407551
2,2021-05-25,51611,8911638,30235,4624025,19477,3970950,1899,316663,19541,880499,0.104727,31699,4162462,0.495086,21690,5042961,0.599813,8407551
2,2021-05-26,49355,8960993,27646,4651671,19987,3990937,1722,318385,19208,871736,0.103685,29829,4192291,0.498634,21066,5064027,0.602319,8407551
2,2021-05-27,47464,9008457,27004,4678675,18689,4009626,1771,320156,18758,864087,0.102775,28428,4220719,0.502015,20779,5084806,0.60479,8407551
2,2021-05-28,50874,9059331,28127,4706802,20738,4030364,2009,322165,21172,857994,0.10205,29423,4250142,0.505515,23330,5108136,0.607565,8407551
2,2021-05-29,29389,9088720,17568,4724370,10733,4041097,1088,323253,13208,856376,0.101858,15980,4266122,0.507416,14362,5122498,0.609273,8407551
2,2021-05-30,12796,9101516,8248,4732618,3773,4044870,775,324028,5531,855531,0.101757,7185,4273307,0.50827,6340,5128838,0.610028,8407551
2,2021-05-31,6014,9107530,3524,4736142,2182,4047052,308,324336,1861,853641,0.101533,4083,4277390,0.508756,2193,5131031,0.610288,8407551
2,2021-06-01,45462,9152992,26120,4762262,17651,4064703,1691,326027,15708,841815,0.100126,29406,4306796,0.512253,17580,5148611,0.612379,8407551
2,2021-06-02,38772,9191764,22812,4785074,14507,4079210,1453,327480,15088,835097,0.099327,23418,4330214,0.515039,16700,5165311,0.614366,8407551
2,2021-06-03,42061,9233825,27123,4812197,13438,4092648,1500,328980,14104,823204,0.097912,27686,4357900,0.518332,15793,5181104,0.616244,8407551
2,2021-06-04,48868,9282693,31924,4844121,15363,4108011,1581,330561,15662,807748,0.096074,32876,4390776,0.522242,17420,5198524,0.618316,8407551
2,2021-06-05,38362,9321055,27402,4871523,9474,4117485,1486,332047,11782,794909,0.094547,26303,4417079,0.52537,13464,5211988,0.619918,8407551
2,2021-06-06,15018,9336073,12312,4883835,2116,4119601,590,332637,4612,789854,0.093946,10319,4427398,0.526598,5264,5217252,0.620544,8407551
2,2021-06-07,33718,9369791,23615,4907450,8810,4128411,1293,333930,10942,779582,0.092724,22590,4449988,0.529285,12318,5229570,0.622009,8407551
2,2021-06-08,40915,9410706,28926,4936376,10602,4139013,1387,335317,12484,765440,0.091042,28182,4478170,0.532637,14040,5243610,0.623679,8407551
2,2021-06-09,38444,9449150,26849,4963225,10083,4149096,1512,336829,11527,751917,0.089434,26679,4504849,0.53581,13156,5256766,0.625243,8407551
2,2021-06-10,38176,9487326,26555,4989780,10074,4159170,1547,338376,11616,738925,0.087888,26340,4531189,0.538943,13348,5270114,0.626831,8407551
2,2021-06-11,41868,9529194,27808,5017588,12366,4171536,1694,340070,13360,725839,0.086332,28258,4559447,0.542304,15172,5285286,0.628636,8407551
2,2021-06-12,29913,9559107,22056,5039644,6929,4178465,928,340998,8629,714370,0.084968,21111,4580558,0.544815,9642,5294928,0.629782,8407551
2,2021-06-13,12311,9571418,8994,5048638,2689,4181154,628,341626,3054,708923,0.08432,9184,4589742,0.545907,3737,5298665,0.630227,8407551
2,2021-06-14,30316,9601734,21508,5070146,7568,4188722,1240,342866,10354,700794,0.083353,19797,4609539,0.548262,11668,5310333,0.631615,8407551
2,2021-06-15,36138,9637872,24092,5094238,9970,4198692,2076,344942,12092,691330,0.082227,23762,4633301,0.551088,14298,5324631,0.633315,8407551
2,2021-06-16,33547,9671419,23189,5117427,8537,4207229,1821,346763,11538,682989,0.081235,21827,4655128,0.553684,13486,5338117,0.634919,8407551
2,2021-06-17,31283,9702702,20919,5138346,8547,4215776,1817,348580,10988,675764,0.080376,20131,4675259,0.556079,12906,5351023,0.636454,8407551
2,2021-06-18,34974,9737676,23041,5161387,10040,4225816,1893,350473,12603,668168,0.079472,22188,4697447,0.558718,14592,5365615,0.63819,8407551
2,2021-06-19,21085,9758761,14700,5176087,5119,4230935,1266,351739,7926,664411,0.079026,13027,4710474,0.560267,9270,5374885,0.639293,8407551
2,2021-06-20,8351,9767112,5974,5182061,1913,4232848,464,352203,3075,662760,0.078829,5228,4715702,0.560889,3577,5378462,0.639718,8407551
2,2021-06-21,19458,9786570,11908,5193969,6213,4239061,1337,353540,9881,664588,0.079047,9458,4725160,0.562014,11286,5389748,0.64106,8407551
2,2021-06-22,27020,9813590,18503,5212472,7131,4246192,1386,354926,10525,660300,0.078537,16322,4741482,0.563955,12034,5401782,0.642492,8407551
2,2021-06-23,26058,9839648,17982,5230454,6437,4252629,1639,356565,10489,657133,0.07816,15426,4756908,0.56579,12259,5414041,0.64395,8407551
2,2021-06-24,25539,9865187,17387,5247841,6622,4259251,1530,358095,10435,654245,0.077816,14952,4771860,0.567568,12064,5426105,0.645385,8407551
2,2021-06-25,28998,9894185,19643,5267484,7845,4267096,1510,359605,12023,651085,0.077441,16793,4788653,0.569566,13633,5439738,0.647006,8407551
2,2021-06-26,18843,9913028,13889,5281373,4015,4271111,939,360544,7611,648603,0.077145,11129,4799782,0.570889,8647,5448385,0.648035,8407551
2,2021-06-27,8928,9921956,6820,5288193,1658,4272769,450,360994,3575,647380,0.077,5287,4805069,0.571518,4064,5452449,0.648518,8407551
2,2021-06-28,20062,9942018,15242,5303435,3571,4276340,1249,362243,8785,646345,0.076877,11123,4816192,0.572841,10088,5462537,0.649718,8407551
2,2021-06-29,23014,9965032,16026,5319461,5901,4282241,1087,363330,9815,644318,0.076636,13026,4829218,0.574391,10999,5473536,0.651026,8407551
2,2021-06-30,22304,9987336,15822,5335283,5450,4287691,1032,364362,9921,643186,0.076501,12173,4841391,0.575838,11041,5484577,0.652339,8407551
2,2021-07-01,20277,10007613,14320,5349603,5053,4292744,904,365266,8971,642024,0.076363,11120,4852511,0.577161,9958,5494535,0.653524,8407551
2,2021-07-02,23253,10030866,16058,5365661,6159,4298903,1036,366302,10271,640603,0.076194,12798,4865309,0.578683,11377,5505912,0.654877,8407551
2,2021-07-03,12712,10043578,9160,5374821,3073,4301976,479,366781,5788,640112,0.076135,6811,4872120,0.579493,6320,5512232,0.655629,8407551
2,2021-07-04,1027,10044605,604,5375425,355,4302331,68,366849,437,640047,0.076128,576,4872696,0.579562,511,5512743,0.65569,8407551
2,2021-07-05,11195,10055800,8199,5383624,2587,4304918,409,367258,5124,639658,0.076081,5980,4878676,0.580273,5591,5518334,0.656355,8407551
2,2021-07-06,24117,10079917,17511,5401135,5587,4310505,1019,368277,9275,635403,0.075575,14662,4893338,0.582017,10407,5528741,0.657592,8407551
2,2021-07-07,20806,10100723,14835,5415970,4853,4315358,1118,369395,8758,633511,0.07535,11882,4905220,0.58343,9990,5538731,0.658781,8407551
2,2021-07-08,19375,10120098,13501,5429471,4819,4320177,1055,370450,8091,631573,0.07512,11162,4916382,0.584758,9224,5547955,0.659878,8407551
2,2021-07-09,22821,10142919,15808,5445279,5743,4325920,1270,371720,9643,629534,0.074877,13025,4929407,0.586307,10986,5558941,0.661184,8407551
2,2021-07-10,14500,10157419,10709,5455988,3100,4329020,691,372411,6375,628615,0.074768,8028,4937435,0.587262,7109,5566050,0.66203,8407551
2,2021-07-11,6614,10164033,4869,5460857,1397,4330417,348,372759,3101,628629,0.07477,3462,4940897,0.587674,3476,5569526,0.662443,8407551
2,2021-07-12,18372,10182405,13500,5474357,3992,4334409,880,373639,7876,627073,0.074585,10370,4951267,0.588907,8814,5578340,0.663492,8407551
2,2021-07-13,19743,10202148,13944,5488301,4905,4339314,894,374533,8831,626118,0.074471,10762,4962029,0.590187,9807,5588147,0.664658,8407551
2,2021-07-14,18896,10221044,13514,5501815,4594,4343908,788,375321,8454,625146,0.074355,10324,4972353,0.591415,9352,5597499,0.66577,8407551
2,2021-07-15,19043,10240087,13806,5515621,4527,4348435,710,376031,8650,624320,0.074257,10271,4982624,0.592637,9445,5606944,0.666894,8407551
2,2021-07-16,23088,10263175,16631,5532252,5619,4354054,838,376869,11036,624360,0.074262,11918,4994542,0.594054,11958,5618902,0.668316,8407551
2,2021-07-17,14491,10277666,10563,5542815,3396,4357450,532,377401,6967,624485,0.074277,7428,5001970,0.594938,7553,5626455,0.669214,8407551
2,2021-07-18,7059,10284725,5275,5548090,1453,4358903,331,377732,3553,624942,0.074331,3454,5005424,0.595349,3911,5630366,0.66968,8407551
2,2021-07-19,18542,10303267,13814,5561904,3977,4362880,751,378483,9169,625657,0.074416,9265,5014689,0.596451,9980,5640346,0.670867,8407551
2,2021-07-20,21149,10324416,15065,5576969,5230,4368110,854,379337,10724,627032,0.07458,10289,5024978,0.597674,11664,5652010,0.672254,8407551
2,2021-07-21,20585,10345001,14992,5591961,4817,4372927,776,380113,10653,628749,0.074784,9783,5034761,0.598838,11500,5663510,0.673622,8407551
2,2021-07-22,20566,10365567,14662,5606623,5028,4377955,876,380989,10952,631195,0.075075,9452,5044213,0.599962,11898,5675408,0.675037,8407551
2,2021-07-23,24759,10390326,17353,5623976,6331,4384286,1075,382064,13435,634635,0.075484,11146,5055359,0.601288,14586,5689994,0.676772,8407551
2,2021-07-24,14957,10405283,10772,5634748,3679,4387965,506,382570,8313,636979,0.075763,6512,5061871,0.602062,8856,5698850,0.677825,8407551
2,2021-07-25,6766,10412049,4987,5639735,1636,4389601,143,382713,4988,640417,0.076172,1716,5063587,0.602267,5154,5704004,0.678438,8407551
2,2021-07-26,19310,10431359,13634,5653369,4883,4394484,793,383506,12183,646490,0.076894,6942,5070529,0.603092,13015,5717019,0.679986,8407551
2,2021-07-27,23140,10454499,16757,5670126,5512,4399996,871,384377,13481,651464,0.077486,9447,5079976,0.604216,14421,5731440,0.681701,8407551
2,2021-07-28,22900,10477399,16369,5686495,5623,4405619,908,385285,13517,656812,0.078122,9144,5089120,0.605303,14492,5745932,0.683425,8407551
2,2021-07-29,21658,10499057,15519,5702014,5217,4410836,922,386207,13032,662377,0.078784,8435,5097555,0.606307,14000,5759932,0.68509,8407551
2,2021-07-30,26500,10525557,18845,5720859,6673,4417509,982,387189,15789,668743,0.079541,10455,5108010,0.60755,16821,5776753,0.687091,8407551
2,2021-07-31,15916,10541473,11724,5732583,3682,4421191,510,387699,9576,672712,0.080013,6166,5114176,0.608284,10135,5786888,0.688297,8407551
2,2021-08-01,8198,10549671,6309,5738892,1716,4422907,173,387872,5338,675505,0.080345,2758,5116934,0.608612,5551,5792439,0.688957,8407551
2,2021-08-02,21586,10571257,16206,5755098,4593,4427500,787,388659,13637,682212,0.081143,7757,5124691,0.609534,14464,5806903,0.690677,8407551
2,2021-08-03,24440,10595697,17837,5772935,5570,4433070,1033,389692,15148,689357,0.081993,9091,5133782,0.610616,16236,5823139,0.692608,8407551
2,2021-08-04,23229,10618926,17225,5790160,5100,4438170,904,390596,14446,696172,0.082803,8565,5142347,0.611634,15380,5838519,0.694438,8407551
2,2021-08-05,23553,10642479,17284,5807444,5301,4443471,968,391564,14577,702985,0.083614,8759,5151106,0.612676,15572,5854091,0.69629,8407551
2,2021-08-06,28150,10670629,20635,5828079,6511,4449982,1004,392568,17117,710394,0.084495,10756,5161862,0.613955,18165,5872256,0.69845,8407551
2,2021-08-07,17183,10687812,12779,5840858,3785,4453767,619,393187,10499,715067,0.085051,6485,5168347,0.614727,11158,5883414,0.699777,8407551
2,2021-08-08,9457,10697269,7162,5848020,2063,4455830,232,393419,5870,717712,0.085365,3477,5171824,0.61514,6122,5889536,0.700506,8407551
2,2021-08-09,23736,10721005,18212,5866232,4741,4460571,783,394202,14308,723651,0.086072,9186,5181010,0.616233,15125,5904661,0.702305,8407551
2,2021-08-10,24914,10745919,18366,5884598,5679,4466250,869,395071,14620,729155,0.086726,10040,5191050,0.617427,15544,5920205,0.704153,8407551
2,2021-08-11,22921,10768840,17106,5901704,4887,4471137,928,395999,13052,733553,0.087249,9613,5200663,0.61857,14011,5934216,0.70582,8407551
2,2021-08-12,24101,10792941,17211,5918915,5780,4476917,1110,397109,13965,738810,0.087875,9856,5210519,0.619743,15113,5949329,0.707617,8407551
2,2021-08-13,30541,10823482,22106,5941021,7335,4484252,1100,398209,17544,744974,0.088608,12526,5223045,0.621233,18690,5968019,0.70984,8407551
2,2021-08-14,19143,10842625,14108,5955129,4485,4488737,550,398759,10692,748531,0.089031,7749,5230794,0.622154,11306,5979325,0.711185,8407551
2,2021-08-15,10534,10853159,7793,5962922,2547,4491284,194,398953,5660,750086,0.089216,4329,5235123,0.622669,5884,5985209,0.711885,8407551
2,2021-08-16,25256,10878415,17877,5980799,6516,4497800,863,399816,12988,753190,0.089585,10779,5245902,0.623951,13883,5999092,0.713536,8407551
2,2021-08-17,26485,10904900,18732,5999531,6793,4504593,960,400776,12999,755355,0.089842,11825,5257727,0.625358,13990,6013082,0.7152,8407551
2,2021-08-18,26806,10931706,19037,6018568,6850,4511443,919,401695,12914,757402,0.090086,11834,5269561,0.626765,13881,6026963,0.716851,8407551
2,2021-08-19,26595,10958301,18394,6036962,7146,4518589,1055,402750,12990,760029,0.090398,11450,5281011,0.628127,14077,6041040,0.718526,8407551
2,2021-08-20,33240,10991541,23375,6060337,8779,4527368,1086,403836,15458,761600,0.090585,15015,5296026,0.629913,16586,6057626,0.720498,8407551
2,2021-08-21,19453,11010994,14391,6074728,4501,4531869,561,404397,9180,762384,0.090678,9013,5305039,0.630985,9797,6067423,0.721664,8407551
2,2021-08-22,10866,11021860,8053,6082781,2597,4534466,216,404613,5246,762944,0.090745,4928,5309967,0.631571,5488,6072911,0.722316,8407551
2,2021-08-23,27297,11049157,19993,6102774,6564,4541030,740,405353,12604,763722,0.090838,12615,5322582,0.633072,13393,6086304,0.723909,8407551
2,2021-08-24,27986,11077143,20846,6123620,6244,4547274,896,406249,12225,763275,0.090784,13614,5336196,0.634691,13167,6099471,0.725475,8407551
2,2021-08-25,26966,11104109,20448,6144068,5745,4553019,773,407022,12078,763307,0.090788,12877,5349073,0.636222,12909,6112380,0.727011,8407551
2,2021-08-26,27079,11131188,20185,6164253,6024,4559043,870,407892,11916,763179,0.090773,12964,5362037,0.637764,12836,6125216,0.728537,8407551
2,2021-08-27,33343,11164531,24751,6189004,7655,4566698,937,408829,13736,761237,0.090542,16681,5378718,0.639748,14739,6139955,0.730291,8407551
2,2021-08-28,19556,11184087,14956,6203960,4220,4570918,380,409209,8198,759868,0.090379,10001,5388719,0.640938,8632,6148587,0.731317,8407551
2,2021-08-29,11262,11195349,8614,6212574,2492,4573410,156,409365,4770,759036,0.09028,5788,5394507,0.641626,4956,6153543,0.731907,8407551
2,2021-08-30,26443,11221792,19685,6232259,6052,4579462,706,410071,10587,756830,0.090018,13550,5408057,0.643238,11344,6164887,0.733256,8407551
2,2021-08-31,25930,11247722,18870,6251129,6324,4585786,736,410807,10292,754690,0.089763,13199,5421256,0.644808,11059,6175946,0.734571,8407551
2,2021-09-01,25161,11272883,18316,6269445,6120,4591906,725,411532,10608,754091,0.089692,11990,5433246,0.646234,11391,6187337,0.735926,8407551
2,2021-09-02,24301,11297184,17423,6286868,6198,4598104,680,412212,9694,752505,0.089503,11999,5445245,0.647661,10413,6197750,0.737165,8407551
2,2021-09-03,30863,11328047,22394,6309262,7710,4605814,759,412971,11538,748747,0.089056,16083,5461328,0.649574,12325,6210075,0.738631,8407551
2,2021-09-04,16696,11344743,12648,6321910,3784,4609598,264,413235,6603,746767,0.088821,8896,5470224,0.650632,6916,6216991,0.739453,8407551
2,2021-09-05,9849,11354592,7392,6329302,2392,4611990,65,413300,4320,746299,0.088765,4871,5475095,0.651212,4403,6221394,0.739977,8407551
2,2021-09-06,5080,11359672,3445,6332747,1593,4613583,42,413342,2083,745762,0.088701,2687,5477782,0.651531,2150,6223544,0.740233,8407551
2,2021-09-07,25132,11384804,18559,6351306,5855,4619438,718,414060,8176,739777,0.08799,14921,5492703,0.653306,8936,6232480,0.741296,8407551
2,2021-09-08,23196,11408000,17001,6368307,5565,4625003,630,414690,8938,737189,0.087682,12194,5504897,0.654756,9606,6242086,0.742438,8407551
2,2021-09-09,23187,11431187,16374,6384681,6079,4631082,734,415424,8678,734325,0.087341,12305,5517202,0.65622,9441,6251527,0.743561,8407551
2,2021-09-10,28086,11459273,19934,6404615,7396,4638478,756,416180,10205,729938,0.086819,15383,5532585,0.65805,10996,6262523,0.744869,8407551
2,2021-09-11,16385,11475658,12058,6416673,4023,4642501,304,416484,6064,727037,0.086474,9331,5541916,0.659159,6430,6268953,0.745634,8407551
2,2021-09-12,9454,11485112,6858,6423531,2433,4644934,163,416647,3666,725680,0.086313,5209,5547125,0.659779,3852,6272805,0.746092,8407551
2,2021-09-13,22211,11507323,15687,6439218,5942,4650876,582,417229,7991,721823,0.085854,12467,5559592,0.661262,8610,6281415,0.747116,8407551
2,2021-09-14,20921,11528244,15001,6454219,5278,4656154,642,417871,7158,717526,0.085343,12142,5571734,0.662706,7845,6289260,0.748049,8407551
2,2021-09-15,20994,11549238,15226,6469445,4975,4661129,793,418664,7416,713780,0.084897,12011,5583745,0.664135,8265,6297525,0.749032,8407551
2,2021-09-16,21358,11570596,15077,6484522,5521,4666650,760,419424,7492,709948,0.084442,12097,5595842,0.665573,8265,6305790,0.750015,8407551
2,2021-09-17,24960,11595556,17742,6502264,6466,4673116,752,420176,8461,704755,0.083824,14451,5610293,0.667292,9258,6315048,0.751116,8407551
2,2021-09-18,14468,11610024,10824,6513088,3307,4676423,337,420513,5180,702033,0.0835,8273,5618566,0.668276,5551,6320599,0.751776,8407551
2,2021-09-19,8516,11618540,6322,6519410,2066,4678489,128,420641,3086,700405,0.083307,4869,5623435,0.668855,3241,6323840,0.752162,8407551
2,2021-09-20,20323,11638863,14530,6533940,5146,4683635,647,421288,7320,697443,0.082954,10962,5634397,0.670159,8000,6331840,0.753113,8407551
2,2021-09-21,19033,11657896,13933,6547873,4404,4688039,696,421984,6847,694760,0.082635,10265,5644662,0.67138,7582,6339422,0.754015,8407551
2,2021-09-22,18459,11676355,13708,6561581,4244,4692283,507,422491,6998,692739,0.082395,9556,5654218,0.672517,7535,6346957,0.754912,8407551
2,2021-09-23,18231,11694586,13273,6574854,4432,4696715,526,423017,6697,691004,0.082188,8989,5663207,0.673586,7254,6354211,0.755774,8407551
2,2021-09-24,25861,11720447,20049,6594903,5214,4701929,598,423615,8242,688048,0.081837,11825,5675032,0.674992,8869,6363080,0.756829,8407551
2,2021-09-25,15731,11736178,12974,6607877,2497,4704426,260,423875,4535,686462,0.081648,6429,5681461,0.675757,4843,6367923,0.757405,8407551
2,2021-09-26,8568,11744746,7305,6615182,1165,4705591,98,423973,2381,685380,0.08152,3582,5685043,0.676183,2500,6370423,0.757703,8407551
2,2021-09-27,23607,11768353,19192,6634374,3897,4709488,518,424491,6771,686658,0.081672,6048,5691091,0.676902,7326,6377749,0.758574,8407551
2,2021-09-28,26746,11795099,22233,6656607,3744,4713232,769,425260,7039,685884,0.08158,8623,5699714,0.677928,7849,6385598,0.759507,8407551
2,2021-09-29,26814,11821913,22463,6679070,3766,4716998,585,425845,7115,685006,0.081475,8619,5708333,0.678953,7741,6393339,0.760428,8407551
2,2021-09-30,27428,11849341,22933,6702003,3886,4720884,609,426454,6709,683511,0.081297,8852,5717185,0.680006,7357,6400696,0.761303,8407551
2,2021-10-01,29720,11879061,24911,6726914,4186,4725070,623,427077,7311,681769,0.08109,9717,5726902,0.681162,7975,6408671,0.762252,8407551
2,2021-10-02,14676,11893737,12416,6739330,2029,4727099,231,427308,4053,680565,0.080947,5517,5732419,0.681818,4313,6412984,0.762765,8407551
2,2021-10-03,4133,11897870,3229,6742559,818,4727917,86,427394,1235,680226,0.080907,1676,5734095,0.682017,1337,6414321,0.762924,8407551
3,2020-07-28,2,2,0,0,2,2,0,0,1,1,0.0,1,1,0.0,2,2,0.0,8129050
3,2020-07-29,3,5,0,0,3,5,0,0,3,4,0.0,0,1,0.0,3,5,1e-06,8129050
3,2020-07-30,2,7,1,1,1,6,0,0,2,6,1e-06,0,1,0.0,2,7,1e-06,8129050
3,2020-07-31,2,9,2,3,0,6,0,0,2,8,1e-06,0,1,0.0,2,9,1e-06,8129050
3,2020-08-03,2,11,0,3,2,8,0,0,2,10,1e-06,0,1,0.0,2,11,1e-06,8129050
3,2020-08-04,2,13,0,3,2,10,0,0,2,12,1e-06,0,1,0.0,2,13,2e-06,8129050
3,2020-08-05,3,16,0,3,3,13,0,0,3,15,2e-06,0,1,0.0,3,16,2e-06,8129050
3,2020-08-06,4,20,1,4,3,16,0,0,4,19,2e-06,0,1,0.0,4,20,2e-06,8129050
3,2020-08-07,3,23,0,4,3,19,0,0,3,22,3e-06,0,1,0.0,3,23,3e-06,8129050
3,2020-08-08,2,25,1,5,1,20,0,0,2,24,3e-06,0,1,0.0,2,25,3e-06,8129050
3,2020-08-10,4,29,3,8,1,21,0,0,4,28,3e-06,0,1,0.0,4,29,4e-06,8129050
3,2020-08-11,9,38,2,10,7,28,0,0,9,37,5e-06,0,1,0.0,9,38,5e-06,8129050
3,2020-08-12,8,46,2,12,6,34,0,0,8,45,6e-06,0,1,0.0,8,46,6e-06,8129050
3,2020-08-13,8,54,3,15,5,39,0,0,8,53,7e-06,0,1,0.0,8,54,7e-06,8129050
3,2020-08-14,5,59,1,16,4,43,0,0,5,58,7e-06,0,1,0.0,5,59,7e-06,8129050
3,2020-08-15,1,60,1,17,0,43,0,0,1,59,7e-06,0,1,0.0,1,60,7e-06,8129050
3,2020-08-17,8,68,5,22,3,46,0,0,8,67,8e-06,0,1,0.0,8,68,8e-06,8129050
3,2020-08-18,3,71,1,23,2,48,0,0,3,70,9e-06,0,1,0.0,3,71,9e-06,8129050
3,2020-08-19,7,78,5,28,2,50,0,0,5,73,9e-06,2,3,0.0,5,76,9e-06,8129050
3,2020-08-20,8,86,5,33,3,53,0,0,8,81,1e-05,0,3,0.0,8,84,1e-05,8129050
3,2020-08-21,11,97,6,39,5,58,0,0,10,91,1.1e-05,0,3,0.0,10,94,1.2e-05,8129050
3,2020-08-22,4,101,4,43,0,58,0,0,4,95,1.2e-05,0,3,0.0,4,98,1.2e-05,8129050
3,2020-08-23,1,102,0,43,1,59,0,0,1,96,1.2e-05,0,3,0.0,1,99,1.2e-05,8129050
3,2020-08-24,9,111,6,49,3,62,0,0,8,103,1.3e-05,1,4,0.0,8,107,1.3e-05,8129050
3,2020-08-25,9,120,6,55,3,65,0,0,8,110,1.4e-05,1,5,1e-06,8,115,1.4e-05,8129050
3,2020-08-26,10,130,3,58,7,72,0,0,8,116,1.4e-05,2,7,1e-06,8,123,1.5e-05,8129050
3,2020-08-27,11,141,10,68,1,73,0,0,9,123,1.5e-05,2,9,1e-06,9,132,1.6e-05,8129050
3,2020-08-28,13,154,8,76,5,78,0,0,11,132,1.6e-05,2,11,1e-06,11,143,1.8e-05,8129050
3,2020-08-29,5,159,2,78,3,81,0,0,5,137,1.7e-05,0,11,1e-06,5,148,1.8e-05,8129050
3,2020-08-31,17,176,15,93,2,83,0,0,15,150,1.8e-05,2,13,2e-06,15,163,2e-05,8129050
3,2020-09-01,23,199,12,105,11,94,0,0,15,157,1.9e-05,8,21,3e-06,15,178,2.2e-05,8129050
3,2020-09-02,7,206,6,111,1,95,0,0,4,158,1.9e-05,3,24,3e-06,4,182,2.2e-05,8129050
3,2020-09-03,18,224,14,125,4,99,0,0,15,170,2.1e-05,3,27,3e-06,15,197,2.4e-05,8129050
3,2020-09-04,16,240,11,136,5,104,0,0,14,182,2.2e-05,2,29,4e-06,14,211,2.6e-05,8129050
3,2020-09-05,2,242,0,136,2,106,0,0,2,184,2.3e-05,0,29,4e-06,2,213,2.6e-05,8129050
3,2020-09-08,23,265,14,150,9,115,0,0,10,181,2.2e-05,13,42,5e-06,10,223,2.7e-05,8129050
3,2020-09-09,21,286,13,163,8,123,0,0,11,182,2.2e-05,10,52,6e-06,11,234,2.9e-05,8129050
3,2020-09-10,19,305,11,174,8,131,0,0,8,179,2.2e-05,11,63,8e-06,8,242,3e-05,8129050
3,2020-09-11,14,319,9,183,5,136,0,0,5,176,2.2e-05,9,72,9e-06,6,248,3.1e-05,8129050
3,2020-09-12,3,322,2,185,1,137,0,0,1,175,2.2e-05,2,74,9e-06,1,249,3.1e-05,8129050
3,2020-09-13,2,324,2,187,0,137,0,0,1,175,2.2e-05,1,75,9e-06,1,250,3.1e-05,8129050
3,2020-09-14,15,339,10,197,5,142,0,0,2,164,2e-05,13,88,1.1e-05,2,252,3.1e-05,8129050
3,2020-09-15,16,355,8,205,8,150,0,0,7,162,2e-05,9,97,1.2e-05,7,259,3.2e-05,8129050
3,2020-09-16,15,370,12,217,3,153,0,0,9,165,2e-05,6,103,1.3e-05,9,268,3.3e-05,8129050
3,2020-09-17,12,382,9,226,3,156,0,0,7,167,2.1e-05,5,108,1.3e-05,7,275,3.4e-05,8129050
3,2020-09-18,17,399,10,236,7,163,0,0,8,166,2e-05,9,117,1.4e-05,8,283,3.5e-05,8129050
3,2020-09-19,4,403,3,239,1,164,0,0,3,168,2.1e-05,1,118,1.5e-05,3,286,3.5e-05,8129050
3,2020-09-20,2,405,1,240,1,165,0,0,0,166,2e-05,2,120,1.5e-05,0,286,3.5e-05,8129050
3,2020-09-21,24,429,19,259,5,170,0,0,8,158,1.9e-05,16,136,1.7e-05,8,294,3.6e-05,8129050
3,2020-09-22,18,447,13,272,5,175,0,0,6,152,1.9e-05,12,148,1.8e-05,6,300,3.7e-05,8129050
3,2020-09-23,20,467,14,286,6,181,0,0,7,146,1.8e-05,13,161,2e-05,7,307,3.8e-05,8129050
3,2020-09-24,13,480,11,297,2,183,0,0,3,140,1.7e-05,9,170,2.1e-05,3,310,3.8e-05,8129050
3,2020-09-25,16,496,11,308,5,188,0,0,2,129,1.6e-05,13,183,2.3e-05,2,312,3.8e-05,8129050
3,2020-09-26,1,497,0,308,1,189,0,0,0,128,1.6e-05,1,184,2.3e-05,0,312,3.8e-05,8129050
3,2020-09-28,8,505,4,312,4,193,0,0,2,124,1.5e-05,6,190,2.3e-05,2,314,3.9e-05,8129050
3,2020-09-29,13,518,8,320,5,198,0,0,1,113,1.4e-05,12,202,2.5e-05,1,315,3.9e-05,8129050
3,2020-09-30,6,524,5,325,0,198,1,1,1,110,1.4e-05,5,207,2.5e-05,2,317,3.9e-05,8129050
3,2020-10-01,10,534,5,330,4,202,1,2,3,107,1.3e-05,7,214,2.6e-05,4,321,3.9e-05,8129050
3,2020-10-02,4,538,4,334,0,202,0,2,0,103,1.3e-05,4,218,2.7e-05,0,321,3.9e-05,8129050
3,2020-10-03,5,543,1,335,3,205,1,3,1,101,1.2e-05,4,222,2.7e-05,2,323,4e-05,8129050
3,2020-10-04,1,544,0,335,1,206,0,3,1,102,1.3e-05,0,222,2.7e-05,1,324,4e-05,8129050
3,2020-10-05,6,550,4,339,2,208,0,3,1,98,1.2e-05,5,227,2.8e-05,1,325,4e-05,8129050
3,2020-10-06,7,557,5,344,1,209,1,4,0,92,1.1e-05,7,234,2.9e-05,1,326,4e-05,8129050
3,2020-10-07,9,566,6,350,3,212,0,4,3,89,1.1e-05,6,240,3e-05,3,329,4e-05,8129050
3,2020-10-08,5,571,3,353,2,214,0,4,1,86,1.1e-05,4,244,3e-05,1,330,4.1e-05,8129050
3,2020-10-09,7,578,5,358,2,216,0,4,0,79,1e-05,7,251,3.1e-05,0,330,4.1e-05,8129050
3,2020-10-10,5,583,1,359,2,218,2,6,0,76,9e-06,5,256,3.1e-05,2,332,4.1e-05,8129050
3,2020-10-12,7,590,6,365,1,219,0,6,0,69,8e-06,7,263,3.2e-05,0,332,4.1e-05,8129050
3,2020-10-13,4,594,2,367,2,221,0,6,0,65,8e-06,4,267,3.3e-05,0,332,4.1e-05,8129050
3,2020-10-14,7,601,4,371,3,224,0,6,1,60,7e-06,6,273,3.4e-05,1,333,4.1e-05,8129050
3,2020-10-15,6,607,4,375,2,226,0,6,0,55,7e-06,5,278,3.4e-05,0,333,4.1e-05,8129050
3,2020-10-16,6,613,4,379,2,228,0,6,2,53,7e-06,4,282,3.5e-05,2,335,4.1e-05,8129050
3,2020-10-17,1,614,0,379,1,229,0,6,0,52,6e-06,1,283,3.5e-05,0,335,4.1e-05,8129050
3,2020-10-19,11,625,7,386,4,233,0,6,7,55,7e-06,4,287,3.5e-05,7,342,4.2e-05,8129050
3,2020-10-20,3,628,1,387,2,235,0,6,3,58,7e-06,0,287,3.5e-05,3,345,4.2e-05,8129050
3,2020-10-21,2,630,1,388,1,236,0,6,1,58,7e-06,1,288,3.5e-05,1,346,4.3e-05,8129050
3,2020-10-22,6,636,5,393,1,237,0,6,5,62,8e-06,1,289,3.6e-05,5,351,4.3e-05,8129050
3,2020-10-23,3,639,3,396,0,237,0,6,3,65,8e-06,0,289,3.6e-05,3,354,4.4e-05,8129050
3,2020-10-26,4,643,2,398,1,238,1,7,2,66,8e-06,2,291,3.6e-05,3,357,4.4e-05,8129050
3,2020-10-27,2,645,1,399,1,239,0,7,2,68,8e-06,0,291,3.6e-05,2,359,4.4e-05,8129050
3,2020-10-28,2,647,0,399,2,241,0,7,2,70,9e-06,0,291,3.6e-05,2,361,4.4e-05,8129050
3,2020-10-29,4,651,3,402,1,242,0,7,4,74,9e-06,0,291,3.6e-05,4,365,4.5e-05,8129050
3,2020-10-30,1,652,0,402,1,243,0,7,0,73,9e-06,1,292,3.6e-05,0,365,4.5e-05,8129050
3,2020-10-31,1,653,1,403,0,243,0,7,1,74,9e-06,0,292,3.6e-05,1,366,4.5e-05,8129050
3,2020-11-01,7,660,6,409,0,243,1,8,6,80,1e-05,1,293,3.6e-05,7,373,4.6e-05,8129050
3,2020-11-02,6,666,2,411,3,246,1,9,4,83,1e-05,2,295,3.6e-05,5,378,4.6e-05,8129050
3,2020-11-03,1,667,1,412,0,246,0,9,1,84,1e-05,0,295,3.6e-05,1,379,4.7e-05,8129050
3,2020-11-04,7,674,2,414,1,247,4,13,0,81,1e-05,7,302,3.7e-05,4,383,4.7e-05,8129050
3,2020-11-05,3,677,0,414,2,249,1,14,1,81,1e-05,2,304,3.7e-05,2,385,4.7e-05,8129050
3,2020-11-09,1,678,1,415,0,249,0,14,0,80,1e-05,1,305,3.8e-05,0,385,4.7e-05,8129050
3,2020-11-10,1,679,0,415,0,249,1,15,0,80,1e-05,1,306,3.8e-05,1,386,4.7e-05,8129050
3,2020-11-11,6,685,5,420,0,249,1,16,0,75,9e-06,6,312,3.8e-05,1,387,4.8e-05,8129050
3,2020-11-12,5,690,2,422,2,251,1,17,2,75,9e-06,3,315,3.9e-05,3,390,4.8e-05,8129050
3,2020-11-13,4,694,3,425,0,251,1,18,0,72,9e-06,4,319,3.9e-05,1,391,4.8e-05,8129050
3,2020-11-14,5,699,2,427,0,251,3,21,2,74,9e-06,3,322,4e-05,5,396,4.9e-05,8129050
3,2020-11-15,1,700,0,427,0,251,1,22,0,74,9e-06,1,323,4e-05,1,397,4.9e-05,8129050
3,2020-11-16,5,705,1,428,1,252,3,25,1,74,9e-06,4,327,4e-05,4,401,4.9e-05,8129050
3,2020-11-17,1,706,1,429,0,252,0,25,0,73,9e-06,1,328,4e-05,0,401,4.9e-05,8129050
3,2020-11-18,3,709,1,430,2,254,0,25,2,74,9e-06,1,329,4e-05,2,403,5e-05,8129050
3,2020-11-19,5,714,0,430,0,254,5,30,0,74,9e-06,5,334,4.1e-05,5,408,5e-05,8129050
3,2020-11-20,8,722,2,432,0,254,6,36,1,74,9e-06,6,340,4.2e-05,6,414,5.1e-05,8129050
3,2020-11-21,3,725,2,434,0,254,1,37,1,74,9e-06,2,342,4.2e-05,2,416,5.1e-05,8129050
3,2020-11-22,3,728,2,436,1,255,0,37,3,77,9e-06,0,342,4.2e-05,3,419,5.2e-05,8129050
3,2020-11-23,7,735,4,440,1,256,2,39,4,80,1e-05,4,346,4.3e-05,7,426,5.2e-05,8129050
3,2020-11-24,4,739,0,440,1,257,3,42,0,79,1e-05,4,350,4.3e-05,3,429,5.3e-05,8129050
3,2020-11-25,5,744,2,442,2,259,1,43,1,78,1e-05,4,354,4.4e-05,3,432,5.3e-05,8129050
3,2020-11-26,1,745,1,443,0,259,0,43,2,80,1e-05,0,354,4.4e-05,2,434,5.3e-05,8129050
3,2020-11-27,5,750,3,446,0,259,2,45,3,83,1e-05,2,356,4.4e-05,5,439,5.4e-05,8129050
3,2020-11-28,2,752,1,447,1,260,0,45,1,83,1e-05,1,357,4.4e-05,1,440,5.4e-05,8129050
3,2020-11-29,1,753,0,447,1,261,0,45,1,84,1e-05,0,357,4.4e-05,1,441,5.4e-05,8129050
3,2020-11-30,7,760,3,450,2,263,2,47,4,87,1.1e-05,2,359,4.4e-05,5,446,5.5e-05,8129050
3,2020-12-01,122,882,84,534,30,293,8,55,108,191,2.3e-05,14,373,4.6e-05,118,564,6.9e-05,8129050
3,2020-12-02,28,910,23,557,2,295,3,58,24,214,2.6e-05,3,376,4.6e-05,26,590,7.3e-05,8129050
3,2020-12-03,33,943,13,570,11,306,9,67,23,237,2.9e-05,10,386,4.7e-05,33,623,7.7e-05,8129050
3,2020-12-04,14,957,1,571,8,314,5,72,9,246,3e-05,5,391,4.8e-05,14,637,7.8e-05,8129050
3,2020-12-05,13,970,7,578,2,316,4,76,9,255,3.1e-05,3,394,4.8e-05,12,649,8e-05,8129050
3,2020-12-06,9,979,5,583,3,319,1,77,8,263,3.2e-05,1,395,4.9e-05,9,658,8.1e-05,8129050
3,2020-12-07,18,997,11,594,6,325,1,78,16,279,3.4e-05,1,396,4.9e-05,17,675,8.3e-05,8129050
3,2020-12-08,26,1023,17,611,6,331,3,81,23,302,3.7e-05,3,399,4.9e-05,26,701,8.6e-05,8129050
3,2020-12-09,12,1035,8,619,2,333,2,83,10,312,3.8e-05,2,401,4.9e-05,12,713,8.8e-05,8129050
3,2020-12-10,16,1051,8,627,3,336,5,88,10,322,4e-05,5,406,5e-05,15,728,9e-05,8129050
3,2020-12-11,15,1066,8,635,2,338,5,93,11,333,4.1e-05,5,411,5.1e-05,16,744,9.2e-05,8129050
3,2020-12-12,18,1084,16,651,0,338,2,95,16,349,4.3e-05,2,413,5.1e-05,18,762,9.4e-05,8129050
3,2020-12-13,10,1094,6,657,3,341,1,96,10,359,4.4e-05,1,414,5.1e-05,11,773,9.5e-05,8129050
3,2020-12-14,23,1117,14,671,8,349,1,97,21,380,4.7e-05,2,416,5.1e-05,23,796,9.8e-05,8129050
3,2020-12-15,352,1469,344,1015,3,352,5,102,337,716,8.8e-05,7,423,5.2e-05,343,1139,0.00014,8129050
3,2020-12-16,2612,4081,2598,3613,8,360,6,108,2572,3281,0.000404,15,438,5.4e-05,2580,3719,0.000457,8129050
3,2020-12-17,8052,12133,8031,11644,10,370,11,119,8009,11280,0.001388,30,468,5.8e-05,8029,11748,0.001445,8129050
3,2020-12-18,13725,25858,13704,25348,21,391,0,119,13660,24919,0.003065,32,500,6.2e-05,13671,25419,0.003127,8129050
3,2020-12-19,7304,33162,7292,32640,12,403,0,119,7333,32245,0.003967,12,512,6.3e-05,7338,32757,0.00403,8129050
3,2020-12-20,5728,38890,5708,38348,20,423,0,119,5756,37994,0.004674,12,524,6.4e-05,5761,38518,0.004738,8129050
3,2020-12-21,14727,53617,14696,53044,31,454,0,119,14677,52633,0.006475,70,594,7.3e-05,14709,53227,0.006548,8129050
3,2020-12-22,15142,68759,14511,67555,631,1085,0,119,15086,67678,0.008325,51,645,7.9e-05,15096,68323,0.008405,8129050
3,2020-12-23,15253,84012,12516,80071,2736,3821,1,120,15197,82855,0.010192,35,680,8.4e-05,15212,83535,0.010276,8129050
3,2020-12-24,6926,90938,4929,85000,1997,5818,0,120,6904,89744,0.01104,20,700,8.6e-05,6909,90444,0.011126,8129050
3,2020-12-25,752,91690,689,85689,63,5881,0,120,738,90472,0.011129,11,711,8.7e-05,739,91183,0.011217,8129050
3,2020-12-26,4698,96388,3025,88714,1673,7554,0,120,4675,95135,0.011703,18,729,9e-05,4681,95864,0.011793,8129050
3,2020-12-27,3075,99463,1889,90603,1186,8740,0,120,3055,98179,0.012078,13,742,9.1e-05,3057,98921,0.012169,8129050
3,2020-12-28,14025,113488,8989,99592,5035,13775,1,121,13942,112071,0.013786,63,805,9.9e-05,13955,112876,0.013886,8129050
3,2020-12-29,15608,129096,8843,108435,6764,20539,1,122,15551,127578,0.015694,59,864,0.000106,15566,128442,0.0158,8129050
3,2020-12-30,18571,147667,10447,118882,8124,28663,0,122,18496,146037,0.017965,51,915,0.000113,18510,146952,0.018077,8129050
3,2020-12-31,8613,156280,3302,122184,5309,33972,2,124,8574,154585,0.019016,36,951,0.000117,8584,155536,0.019133,8129050
3,2021-01-01,2111,158391,991,123175,1084,35056,36,160,2013,156557,0.019259,80,1031,0.000127,2052,157588,0.019386,8129050
3,2021-01-02,5070,163461,2509,125684,2561,37617,0,160,5020,161539,0.019872,41,1072,0.000132,5023,162611,0.020004,8129050
3,2021-01-03,1686,165147,900,126584,785,38402,1,161,1640,163147,0.02007,35,1107,0.000136,1643,164254,0.020206,8129050
3,2021-01-04,13150,178297,6972,133556,6177,44579,1,162,12181,174431,0.021458,905,2012,0.000248,12189,176443,0.021705,8129050
3,2021-01-05,16069,194366,8370,141926,7695,52274,4,166,14244,186978,0.023001,1728,3740,0.00046,14275,190718,0.023461,8129050
3,2021-01-06,20949,215315,11133,153059,9814,62088,2,168,16157,198449,0.024412,4689,8429,0.001037,16160,206878,0.025449,8129050
3,2021-01-07,26990,242305,15441,168500,11548,73636,1,169,17333,206218,0.025368,9570,17999,0.002214,17339,224217,0.027582,8129050
3,2021-01-08,31140,273445,19024,187524,12116,85752,0,169,18275,211736,0.026047,12764,30763,0.003784,18282,242499,0.029831,8129050
3,2021-01-09,12680,286125,7168,194692,5509,91261,3,172,8027,215148,0.026467,4624,35387,0.004353,8036,250535,0.03082,8129050
3,2021-01-10,7292,293417,4521,199213,2769,94030,2,174,4061,215998,0.026571,3215,38602,0.004749,4065,254600,0.03132,8129050
3,2021-01-11,29715,323132,19464,218677,10249,104279,2,176,16702,219839,0.027044,12881,51483,0.006333,16722,271322,0.033377,8129050
3,2021-01-12,33238,356370,19734,238411,13504,117783,0,176,20274,227369,0.02797,12835,64318,0.007912,20365,291687,0.035882,8129050
3,2021-01-13,35182,391552,18346,256757,16836,134619,0,176,24652,241598,0.02972,10441,74759,0.009197,24670,316357,0.038917,8129050
3,2021-01-14,35230,426782,14431,271188,20796,155415,3,179,29132,264808,0.032576,5949,80708,0.009928,29159,345516,0.042504,8129050
3,2021-01-15,39631,466413,14738,285926,24888,180303,5,184,34710,294781,0.036263,4808,85516,0.01052,34781,380297,0.046782,8129050
3,2021-01-16,22124,488537,7536,293462,14585,194888,3,187,19653,312050,0.038387,2402,87918,0.010815,19671,399968,0.049202,8129050
3,2021-01-17,13298,501835,4541,298003,8756,203644,1,188,12143,323090,0.039745,1115,89033,0.010952,12155,412123,0.050698,8129050
3,2021-01-18,25042,526877,13112,311115,11929,215573,1,189,19209,336595,0.041406,5746,94779,0.011659,19251,431374,0.053066,8129050
3,2021-01-19,41766,568643,21275,332390,20490,236063,1,190,32135,359275,0.044196,9493,104272,0.012827,32173,463547,0.057024,8129050
3,2021-01-20,46812,615455,23336,355726,23474,259537,2,192,36831,386319,0.047523,9837,114109,0.014037,36881,500428,0.06156,8129050
3,2021-01-21,48808,664263,21205,376931,27601,287138,2,194,42871,423504,0.052098,5753,119862,0.014745,42938,543366,0.066842,8129050
3,2021-01-22,50487,714750,20113,397044,30371,317509,3,197,45983,465131,0.057218,4421,124283,0.015289,46048,589414,0.072507,8129050
3,2021-01-23,30766,745516,12914,409958,17852,335361,0,197,27369,489230,0.060183,3322,127605,0.015697,27421,616835,0.07588,8129050
3,2021-01-24,18149,763665,8606,418564,9543,344904,0,197,16917,504964,0.062118,1213,128818,0.015847,16947,633782,0.077965,8129050
3,2021-01-25,41623,805288,18545,437109,23075,367979,3,200,31235,525984,0.064704,10259,139077,0.017109,31279,665061,0.081813,8129050
3,2021-01-26,48096,853384,22994,460103,25102,393081,0,200,37568,553173,0.068049,10419,149496,0.01839,37608,702669,0.086439,8129050
3,2021-01-27,52420,905804,25000,485103,27418,420499,2,202,41487,583868,0.071825,10859,160355,0.019726,41554,744223,0.091551,8129050
3,2021-01-28,53064,958868,24631,509734,28433,448932,0,202,43707,618398,0.076073,9217,169572,0.02086,43747,787970,0.096933,8129050
3,2021-01-29,52004,1010872,24887,534621,27117,476049,0,202,41848,650402,0.08001,9890,179462,0.022077,41894,829864,0.102086,8129050
3,2021-01-30,38005,1048877,17906,552527,20099,496148,0,202,33154,678842,0.083508,4754,184216,0.022661,33194,863058,0.10617,8129050
3,2021-01-31,23073,1071950,13021,565548,10052,506200,0,202,21598,699009,0.085989,1446,185662,0.022839,21613,884671,0.108828,8129050
3,2021-02-01,46978,1118928,21451,586999,25501,531701,26,228,35610,723475,0.088999,11194,196856,0.024216,35660,920331,0.113215,8129050
3,2021-02-02,55364,1174292,23122,610121,32240,563941,2,230,42457,753225,0.092658,12733,209589,0.025783,42483,962814,0.118441,8129050
3,2021-02-03,60861,1235153,27049,637170,33810,597751,2,232,45073,782779,0.096294,15569,225158,0.027698,45123,1007937,0.123992,8129050
3,2021-02-04,65374,1300527,28332,665502,37036,634787,6,238,47544,812867,0.099995,17535,242693,0.029855,47623,1055560,0.12985,8129050
3,2021-02-05,71841,1372368,30199,695701,41640,676427,2,240,49327,840158,0.103353,22133,264826,0.032578,49424,1104984,0.13593,8129050
3,2021-02-06,44419,1416787,21245,716946,23174,699601,0,240,34459,864819,0.106386,9858,274684,0.03379,34519,1139503,0.140177,8129050
3,2021-02-07,20179,1436966,12879,729825,7298,706899,2,242,15423,875572,0.107709,4695,279379,0.034368,15448,1154951,0.142077,8129050
3,2021-02-08,52404,1489370,25315,755140,27087,733986,2,244,34077,891615,0.109683,18111,297490,0.036596,34154,1189105,0.146278,8129050
3,2021-02-09,59625,1548995,28863,784003,30758,764744,4,248,34633,901608,0.110912,24724,322214,0.039637,34717,1223822,0.150549,8129050
3,2021-02-10,69377,1618372,32224,816227,37148,801892,5,253,36713,906384,0.111499,32116,354330,0.043588,36892,1260714,0.155087,8129050
3,2021-02-11,71776,1690148,35247,851474,36524,838416,5,258,37813,910835,0.112047,33494,387824,0.047708,37945,1298659,0.159755,8129050
3,2021-02-12,76698,1766846,32982,884456,43712,882128,4,262,41967,918666,0.11301,34328,422152,0.051931,42159,1340818,0.164942,8129050
3,2021-02-13,45654,1812500,20630,905086,25022,907150,2,264,25970,925298,0.113826,19477,441629,0.054327,26109,1366927,0.168153,8129050
3,2021-02-14,27768,1840268,13879,918965,13887,921037,2,266,15280,928327,0.114199,12378,454007,0.05585,15407,1382334,0.170049,8129050
3,2021-02-15,40778,1881046,17592,936557,23178,944215,8,274,22290,932519,0.114714,18288,472295,0.0581,22480,1404814,0.172814,8129050
3,2021-02-16,71381,1952427,33773,970330,37605,981820,3,277,36608,934958,0.115014,34489,506784,0.062342,36928,1441742,0.177357,8129050
3,2021-02-17,73257,2025684,36971,1007301,36278,1018098,8,285,34249,930741,0.114496,38620,545404,0.067093,34403,1476145,0.181589,8129050
3,2021-02-18,78277,2103961,40844,1048145,37428,1055526,5,290,35777,924550,0.113734,42163,587567,0.07228,35972,1512117,0.186014,8129050
3,2021-02-19,70391,2174352,40565,1088710,29825,1085351,1,291,35200,924951,0.113783,34920,622487,0.076576,35321,1547438,0.190359,8129050
3,2021-02-20,43879,2218231,27670,1116380,16207,1101558,2,293,22661,926683,0.113996,21052,643539,0.079165,22784,1570222,0.193162,8129050
3,2021-02-21,24821,2243052,19938,1136318,4882,1106440,1,294,11828,925797,0.113887,12861,656400,0.080747,11975,1582197,0.194635,8129050
3,2021-02-22,48224,2291276,31384,1167702,16835,1123275,5,299,22398,922717,0.113509,25611,682011,0.083898,22531,1604728,0.197407,8129050
3,2021-02-23,64650,2355926,35052,1202754,29597,1152872,1,300,27841,914458,0.112493,36488,718499,0.088387,28229,1632957,0.200879,8129050
3,2021-02-24,80786,2436712,39708,1242462,41074,1193946,4,304,35204,904963,0.111325,45178,763677,0.093944,35683,1668640,0.205269,8129050
3,2021-02-25,90631,2527343,44193,1286655,46435,1240381,3,307,44718,904719,0.111295,45403,809080,0.099529,45159,1713799,0.210824,8129050
3,2021-02-26,101890,2629233,46564,1333219,55321,1295702,5,312,53414,910612,0.112019,47836,856916,0.105414,53729,1767528,0.217434,8129050
3,2021-02-27,72025,2701258,33154,1366373,38862,1334564,9,321,37537,914233,0.112465,34132,891048,0.109613,37753,1805281,0.222078,8129050
3,2021-02-28,42132,2743390,24363,1390736,17763,1352327,6,327,21155,914901,0.112547,20718,911766,0.112161,21386,1826667,0.224709,8129050
3,2021-03-01,71690,2815080,37951,1428687,33672,1385999,67,394,39600,923206,0.113569,31690,943456,0.11606,39995,1866662,0.229629,8129050
3,2021-03-02,83724,2898804,41428,1470115,42277,1428276,19,413,47901,935983,0.115141,35523,978979,0.12043,48300,1914962,0.23557,8129050
3,2021-03-03,93196,2992000,44714,1514829,48441,1476717,41,454,51735,947161,0.116516,41018,1019997,0.125476,52196,1967158,0.241991,8129050
3,2021-03-04,97807,3089807,47959,1562788,49817,1526534,31,485,55006,960226,0.118123,42423,1062420,0.130694,55488,2022646,0.248817,8129050
3,2021-03-05,94458,3184265,46041,1608829,48033,1574567,384,869,56490,979922,0.120546,37528,1099948,0.135311,57224,2079870,0.255856,8129050
3,2021-03-06,67256,3251521,34036,1642865,31004,1605571,2216,3085,38004,991374,0.121954,28992,1128940,0.138877,40444,2120314,0.260832,8129050
3,2021-03-07,40532,3292053,23341,1666206,15233,1620804,1958,5043,22646,998405,0.122819,17742,1146682,0.14106,24773,2145087,0.263879,8129050
3,2021-03-08,61791,3353844,29429,1695635,29274,1650078,3088,8131,38767,1017733,0.125197,22756,1169438,0.143859,42084,2187171,0.269056,8129050
3,2021-03-09,79083,3432927,36468,1732103,37949,1688027,4666,12797,42124,1028037,0.126465,36663,1206101,0.148369,46967,2234138,0.274834,8129050
3,2021-03-10,85327,3518254,42327,1774430,36760,1724787,6240,19037,44157,1037770,0.127662,40850,1246951,0.153394,50583,2284721,0.281056,8129050
3,2021-03-11,99362,3617616,48549,1822979,42073,1766860,8740,27777,48188,1044054,0.128435,50805,1297756,0.159644,57089,2341810,0.288079,8129050
3,2021-03-12,104289,3721905,46435,1869414,45851,1812711,12003,39780,46861,1046025,0.128677,57034,1354790,0.16666,59005,2400815,0.295338,8129050
3,2021-03-13,72239,3794144,30256,1899670,34627,1847338,7356,47136,37291,1056117,0.129919,34701,1389491,0.170929,44793,2445608,0.300848,8129050
3,2021-03-14,42293,3836437,21910,1921580,16783,1864121,3600,50736,20993,1059633,0.130351,21149,1410640,0.173531,24665,2470273,0.303882,8129050
3,2021-03-15,77120,3913557,36593,1958173,35884,1900005,4643,55379,40334,1068289,0.131416,36444,1447084,0.178014,45100,2515373,0.30943,8129050
3,2021-03-16,96710,4010267,44625,2002798,47689,1947694,4396,59775,53954,1084347,0.133392,42411,1489495,0.183231,58469,2573842,0.316623,8129050
3,2021-03-17,100215,4110482,48648,2051446,46938,1994632,4629,64404,60404,1109993,0.136546,39466,1528961,0.188086,65112,2638954,0.324633,8129050
3,2021-03-18,105238,4215720,53468,2104914,47158,2041790,4612,69016,59835,1129485,0.138944,45034,1573995,0.193626,64526,2703480,0.33257,8129050
3,2021-03-19,105029,4320749,56483,2161397,44031,2085821,4515,73531,58072,1145552,0.140921,46580,1620575,0.199356,62647,2766127,0.340277,8129050
3,2021-03-20,72919,4393668,37565,2198962,31603,2117424,3751,77282,44598,1165879,0.143421,28078,1648653,0.20281,48405,2814532,0.346231,8129050
3,2021-03-21,36842,4430510,24986,2223948,10310,2127734,1546,78828,21975,1174727,0.14451,14699,1663352,0.204618,23547,2838079,0.349128,8129050
3,2021-03-22,71410,4501920,41934,2265882,26917,2154651,2559,81387,45185,1196561,0.147196,25970,1689322,0.207813,47804,2885883,0.355009,8129050
3,2021-03-23,91096,4593016,50427,2316309,38068,2192719,2601,83988,55025,1218461,0.14989,35785,1725107,0.212215,57685,2943568,0.362105,8129050
3,2021-03-24,100249,4693265,57677,2373986,39592,2232311,2980,86968,56432,1234455,0.151857,43492,1768599,0.217565,59486,3003054,0.369423,8129050
3,2021-03-25,109006,4802271,60557,2434543,45372,2277683,3077,90045,60668,1250278,0.153804,47999,1816598,0.22347,63822,3066876,0.377274,8129050
3,2021-03-26,112464,4914735,60335,2494878,48703,2326386,3426,93471,57251,1256120,0.154522,54891,1871489,0.230222,60733,3127609,0.384745,8129050
3,2021-03-27,75611,4990346,38463,2533341,34552,2360938,2596,96067,36275,1255915,0.154497,39122,1910611,0.235035,38917,3166526,0.389532,8129050
3,2021-03-28,44946,5035292,28329,2561670,15789,2376727,828,96895,22328,1256607,0.154582,22509,1933120,0.237804,23201,3189727,0.392386,8129050
3,2021-03-29,82045,5117337,42822,2604492,37337,2414064,1886,98781,44127,1265038,0.155619,37672,1970792,0.242438,46103,3235830,0.398058,8129050
3,2021-03-30,101888,5219225,50108,2654600,48034,2462098,3746,102527,56082,1279437,0.157391,45496,2016288,0.248035,59895,3295725,0.405426,8129050
3,2021-03-31,106599,5325824,57446,2712046,44236,2506334,4917,107444,56206,1290463,0.158747,50145,2066433,0.254204,61171,3356896,0.412951,8129050
3,2021-04-01,125651,5451475,63480,2775526,52262,2558596,9909,117353,66804,1308794,0.161002,58391,2124824,0.261387,76722,3433618,0.422389,8129050
3,2021-04-02,119531,5571006,58359,2833885,50654,2609250,10518,127871,62183,1324518,0.162936,57018,2181842,0.268401,72742,3506360,0.431337,8129050
3,2021-04-03,76921,5647927,39334,2873219,28234,2637484,9353,137224,37917,1332979,0.163977,38824,2220666,0.273177,47285,3553645,0.437154,8129050
3,2021-04-04,32744,5680671,17510,2890729,10972,2648456,4262,141486,13999,1332586,0.163929,18664,2239330,0.275473,18271,3571916,0.439401,8129050
3,2021-04-05,91259,5771930,46288,2937017,35527,2683983,9444,150930,43518,1338116,0.164609,47506,2286836,0.281317,53036,3624952,0.445926,8129050
3,2021-04-06,114915,5886845,55949,2992966,43577,2727560,15389,166319,53309,1345545,0.165523,61297,2348133,0.288857,68726,3693678,0.45438,8129050
3,2021-04-07,117721,6004566,60896,3053862,40345,2767905,16480,182799,56166,1356959,0.166927,61215,2409348,0.296387,72629,3766307,0.463315,8129050
3,2021-04-08,122703,6127269,61062,3114924,41220,2809125,20421,203220,56359,1367736,0.168253,66026,2475374,0.30451,76803,3843110,0.472762,8129050
3,2021-04-09,120153,6247422,59927,3174851,40857,2849982,19369,222589,52126,1371510,0.168717,67732,2543106,0.312842,71506,3914616,0.481559,8129050
3,2021-04-10,85514,6332936,38329,3213180,31699,2881681,15486,238075,34543,1370802,0.16863,50740,2593846,0.319084,50032,3964648,0.487714,8129050
3,2021-04-11,45798,6378734,24496,3237676,13166,2894847,8136,246211,17199,1367682,0.168246,28492,2622338,0.322588,25372,3990020,0.490835,8129050
3,2021-04-12,84900,6463634,42829,3280505,33122,2927969,8949,255160,38028,1368096,0.168297,46644,2668982,0.328326,47058,4037078,0.496624,8129050
3,2021-04-13,106575,6570209,57695,3338200,48663,2976632,217,255377,55575,1373278,0.168935,50715,2719697,0.334565,55897,4092975,0.5035,8129050
3,2021-04-14,108837,6679046,59508,3397708,49215,3025847,114,255491,53550,1372135,0.168794,54932,2774629,0.341323,53789,4146764,0.510117,8129050
3,2021-04-15,120421,6799467,67693,3465401,52636,3078483,92,255583,63605,1379576,0.169709,56349,2830978,0.348254,63790,4210554,0.517964,8129050
3,2021-04-16,116763,6916230,65480,3530881,51185,3129668,98,255681,60402,1384256,0.170285,55915,2886893,0.355133,60595,4271149,0.525418,8129050
3,2021-04-17,80279,6996509,43809,3574690,36453,3166121,17,255698,44429,1393194,0.171385,35609,2922502,0.359513,44547,4315696,0.530898,8129050
3,2021-04-18,39288,7035797,23795,3598485,15484,3181605,9,255707,18240,1390594,0.171065,20918,2943420,0.362087,18318,4334014,0.533151,8129050
3,2021-04-19,79868,7115665,44442,3642927,35367,3216972,59,255766,35474,1382190,0.170031,44013,2987433,0.367501,35609,4369623,0.537532,8129050
3,2021-04-20,101522,7217187,53449,3696376,48048,3265020,25,255791,48344,1378082,0.169526,52587,3040020,0.37397,48479,4418102,0.543495,8129050
3,2021-04-21,106898,7324085,60000,3756376,46818,3311838,80,255871,50033,1371951,0.168771,56383,3096403,0.380906,50252,4468354,0.549677,8129050
3,2021-04-22,113074,7437159,63519,3819895,49524,3361362,31,255902,48143,1355768,0.166781,64469,3160872,0.388837,48286,4516640,0.555617,8129050
3,2021-04-23,107314,7544473,61366,3881261,45916,3407278,32,255934,46582,1342164,0.165107,60325,3221197,0.396257,46721,4563361,0.561365,8129050
3,2021-04-24,74775,7619248,46125,3927386,28573,3435851,77,256011,36163,1340238,0.16487,38282,3259479,0.400967,36356,4599717,0.565837,8129050
3,2021-04-25,37257,7656505,23756,3951142,13482,3449333,19,256030,18872,1340969,0.16496,18211,3277690,0.403207,18942,4618659,0.568167,8129050
3,2021-04-26,74837,7731342,42310,3993452,32096,3481429,431,256461,31643,1330311,0.163649,42851,3320541,0.408478,32193,4650852,0.572127,8129050
3,2021-04-27,92116,7823458,48365,4041817,41969,3523398,1782,258243,36178,1312793,0.161494,55593,3376134,0.415317,38075,4688927,0.576811,8129050
3,2021-04-28,87982,7911440,49939,4091756,35871,3559269,2172,260415,35567,1298533,0.15974,52061,3428195,0.421721,37801,4726728,0.581461,8129050
3,2021-04-29,90482,8001922,51576,4143332,36609,3595878,2297,262712,31968,1274764,0.156816,58114,3486309,0.42887,34345,4761073,0.585686,8129050
3,2021-04-30,92275,8094197,51930,4195262,37792,3633670,2553,265265,34076,1253700,0.154225,57762,3544071,0.435976,36698,4797771,0.590201,8129050
3,2021-05-01,56780,8150977,35391,4230653,19858,3653528,1531,266796,20397,1239640,0.152495,36046,3580117,0.44041,21986,4819757,0.592905,8129050
3,2021-05-02,27361,8178338,18671,4249324,7633,3661161,1057,267853,9918,1233333,0.151719,17319,3597436,0.442541,11012,4830769,0.59426,8129050
3,2021-05-03,60570,8238908,35586,4284910,22588,3683749,2396,270249,17404,1210263,0.148881,42899,3640335,0.447818,19829,4850598,0.596699,8129050
3,2021-05-04,78334,8317242,45255,4330165,30364,3714113,2715,272964,22498,1180009,0.14516,55516,3695851,0.454647,25262,4875860,0.599807,8129050
3,2021-05-05,79936,8397178,47962,4378127,29228,3743341,2746,275710,21867,1146945,0.141092,57743,3753594,0.461751,24679,4900539,0.602843,8129050
3,2021-05-06,84139,8481317,53241,4431368,28342,3771683,2556,278266,20514,1106859,0.136161,63212,3816806,0.469527,23126,4923665,0.605688,8129050
3,2021-05-07,83390,8564707,51975,4483343,28747,3800430,2668,280934,21767,1070122,0.131642,61220,3878026,0.477058,24483,4948148,0.608699,8129050
3,2021-05-08,53252,8617959,32981,4516324,18532,3818962,1739,282673,13944,1046842,0.128778,39036,3917062,0.48186,15756,4963904,0.610638,8129050
3,2021-05-09,21297,8639256,15562,4531886,4934,3823896,801,283474,5436,1037333,0.127608,15753,3932815,0.483798,6244,4970148,0.611406,8129050
3,2021-05-10,48727,8687983,26242,4558128,20548,3844444,1937,285411,11132,1013093,0.124626,37365,3970180,0.488394,13125,4983273,0.61302,8129050
3,2021-05-11,64800,8752783,36341,4594469,26204,3870648,2255,287666,16094,983078,0.120934,48435,4018615,0.494352,18420,5001693,0.615286,8129050
3,2021-05-12,65488,8818271,37608,4632077,25451,3896099,2429,290095,16559,953495,0.117295,48637,4067252,0.500335,19054,5020747,0.61763,8129050
3,2021-05-13,76167,8894438,47975,4680052,26253,3922352,1939,292034,27619,934858,0.115002,48281,4115533,0.506275,29644,5050391,0.621277,8129050
3,2021-05-14,81472,8975910,51343,4731395,27914,3950266,2215,294249,31367,918734,0.113019,49771,4165304,0.512397,33647,5084038,0.625416,8129050
3,2021-05-15,62909,9038819,43347,4774742,18320,3968586,1242,295491,25836,909055,0.111828,36812,4202116,0.516926,27133,5111171,0.628754,8129050
3,2021-05-16,33524,9072343,25076,4799818,7742,3976328,706,296197,13426,903240,0.111113,19971,4222087,0.519383,14156,5125327,0.630495,8129050
3,2021-05-17,57617,9129960,36656,4836474,19082,3995410,1879,298076,21052,889979,0.109481,36254,4258341,0.523842,22993,5148320,0.633324,8129050
3,2021-05-18,65208,9195168,38482,4874956,24829,4020239,1897,299973,24324,875711,0.107726,40561,4298902,0.528832,26293,5174613,0.636558,8129050
3,2021-05-19,64674,9259842,39316,4914272,23579,4043818,1779,301752,24850,862890,0.106149,39522,4338424,0.533694,26701,5201314,0.639843,8129050
3,2021-05-20,62449,9322291,36534,4950806,24047,4067865,1868,303620,22224,847191,0.104218,39884,4378308,0.5386,24185,5225499,0.642818,8129050
3,2021-05-21,67004,9389295,40690,4991496,24184,4092049,2130,305750,23763,830286,0.102138,42880,4421188,0.543875,25975,5251474,0.646013,8129050
3,2021-05-22,46283,9435578,30662,5022158,14127,4106176,1494,307244,19085,824009,0.101366,26932,4448120,0.547188,20655,5272129,0.648554,8129050
3,2021-05-23,21991,9457569,15211,5037369,6116,4112292,664,307908,9207,821228,0.101024,12688,4460808,0.548749,9907,5282036,0.649773,8129050
3,2021-05-24,40136,9497705,23503,5060872,14845,4127137,1788,309696,14716,812611,0.099964,25196,4486004,0.551848,16579,5298615,0.651812,8129050
3,2021-05-25,43366,9541071,24401,5085273,17256,4144393,1709,311405,15274,801848,0.09864,27786,4513790,0.555267,17023,5315638,0.653906,8129050
3,2021-05-26,42897,9583968,24508,5109781,16632,4161025,1757,313162,15970,792956,0.097546,26619,4540409,0.558541,17727,5333365,0.656087,8129050
3,2021-05-27,39838,9623806,22324,5132105,15748,4176773,1766,314928,15410,785987,0.096689,24235,4564644,0.561522,17266,5350631,0.658211,8129050
3,2021-05-28,43398,9667204,24535,5156640,17044,4193817,1819,316747,17867,780447,0.096007,25287,4589931,0.564633,19747,5370378,0.66064,8129050
3,2021-05-29,23738,9690942,14500,5171140,8391,4202208,847,317594,10866,779508,0.095892,12684,4602615,0.566193,11745,5382123,0.662085,8129050
3,2021-05-30,10768,9701710,6995,5178135,3135,4205343,638,318232,4492,778473,0.095764,6183,4608798,0.566954,5148,5387271,0.662718,8129050
3,2021-05-31,4743,9706453,2742,5180877,1732,4207075,269,318501,1458,776996,0.095583,3212,4612010,0.567349,1735,5389006,0.662932,8129050
3,2021-06-01,38296,9744749,22040,5202917,14774,4221849,1482,319983,13256,767049,0.094359,24739,4636749,0.570392,14792,5403798,0.664751,8129050
3,2021-06-02,31854,9776603,18342,5221259,12083,4233932,1429,321412,11694,760266,0.093525,19952,4656701,0.572847,13169,5416967,0.666371,8129050
3,2021-06-03,40086,9816689,27427,5248686,11204,4245136,1455,322867,11471,744834,0.091626,28432,4685133,0.576344,13000,5429967,0.667971,8129050
3,2021-06-04,46846,9863535,33171,5281857,12116,4257252,1559,324426,13215,726372,0.089355,33362,4718495,0.580449,14900,5444867,0.669804,8129050
3,2021-06-05,34773,9898308,26225,5308082,7351,4264603,1197,325623,8679,710461,0.087398,25856,4744351,0.583629,9945,5454812,0.671027,8129050
3,2021-06-06,14805,9913113,12359,5320441,1853,4266456,593,326216,3653,703673,0.086563,11080,4755431,0.584992,4292,5459104,0.671555,8129050
3,2021-06-07,30783,9943896,22366,5342807,7115,4273571,1302,327518,8816,692038,0.085131,21793,4777224,0.587673,10158,5469262,0.672805,8129050
3,2021-06-08,34569,9978465,24812,5367619,8452,4282023,1305,328823,9963,678963,0.083523,24429,4801653,0.590678,11354,5480616,0.674201,8129050
3,2021-06-09,33275,10011740,24148,5391767,7810,4289833,1317,330140,8841,664963,0.081801,24223,4825876,0.593658,10223,5490839,0.675459,8129050
3,2021-06-10,32790,10044530,23662,5415429,7582,4297415,1546,331686,8958,651875,0.080191,23655,4849531,0.596568,10567,5501406,0.676759,8129050
3,2021-06-11,36025,10080555,25477,5440906,9155,4306570,1393,333079,10638,638742,0.078575,25212,4874743,0.599669,12079,5513485,0.678245,8129050
3,2021-06-12,25595,10106150,19305,5460211,5383,4311953,907,333986,6695,627640,0.07721,18748,4893491,0.601976,7646,5521131,0.679185,8129050
3,2021-06-13,10240,10116390,7670,5467881,2077,4314030,493,334479,2331,622638,0.076594,7852,4901343,0.602942,2850,5523981,0.679536,8129050
3,2021-06-14,26155,10142545,18758,5486639,5945,4319975,1452,335931,8087,614269,0.075565,17946,4919289,0.605149,9577,5533558,0.680714,8129050
3,2021-06-15,29152,10171697,19727,5506366,7889,4327864,1536,337467,9771,606435,0.074601,19194,4938483,0.60751,11360,5544918,0.682111,8129050
3,2021-06-16,26263,10197960,18664,5525030,6156,4334020,1443,338910,8846,599538,0.073753,17230,4955713,0.60963,10333,5555251,0.683383,8129050
3,2021-06-17,25132,10223092,17985,5543015,5830,4339850,1317,340227,8691,593317,0.072987,16275,4971988,0.611632,10054,5565305,0.684619,8129050
3,2021-06-18,28144,10251236,19866,5562881,6700,4346550,1578,341805,9813,586594,0.07216,18164,4990152,0.613867,11441,5576746,0.686027,8129050
3,2021-06-19,16094,10267330,11814,5574695,3418,4349968,862,342667,5762,583023,0.071721,10237,5000389,0.615126,6666,5583412,0.686847,8129050
3,2021-06-20,6943,10274273,5210,5579905,1424,4351392,309,342976,2593,581668,0.071554,4280,5004669,0.615652,2925,5586337,0.687207,8129050
3,2021-06-21,16359,10290632,10328,5590233,4619,4356011,1412,344388,8091,583050,0.071724,8166,5012835,0.616657,9548,5595885,0.688381,8129050
3,2021-06-22,22239,10312871,15589,5605822,5332,4361343,1318,345706,8239,578780,0.071199,13866,5026701,0.618363,9596,5605481,0.689562,8129050
3,2021-06-23,20385,10333256,14275,5620097,4759,4366102,1351,347057,8023,575958,0.070852,12224,5038925,0.619866,9402,5614883,0.690718,8129050
3,2021-06-24,20071,10353327,13969,5634066,4643,4370745,1459,348516,7798,573147,0.070506,12092,5051017,0.621354,9281,5624164,0.69186,8129050
3,2021-06-25,23477,10376804,16647,5650713,5401,4376146,1429,349945,9087,569458,0.070052,14231,5065248,0.623105,10542,5634706,0.693157,8129050
3,2021-06-26,14116,10390920,10483,5661196,2859,4379005,774,350719,5862,567994,0.069872,8133,5073381,0.624105,6669,5641375,0.693977,8129050
3,2021-06-27,6791,10397711,5262,5666458,1219,4380224,310,351029,2870,567313,0.069788,3858,5077239,0.62458,3177,5644552,0.694368,8129050
3,2021-06-28,16204,10413915,12454,5678912,2657,4382881,1093,352122,6779,565939,0.069619,9271,5086510,0.62572,7897,5652449,0.695339,8129050
3,2021-06-29,18270,10432185,12864,5691776,4379,4387260,1027,353149,7460,563845,0.069362,10611,5097121,0.627025,8517,5660966,0.696387,8129050
3,2021-06-30,17317,10449502,12281,5704057,3982,4391242,1054,354203,7452,562772,0.06923,9611,5106732,0.628208,8538,5669504,0.697437,8129050
3,2021-07-01,16588,10466090,11813,5715870,3691,4394933,1084,355287,6940,561384,0.069059,9431,5116163,0.629368,8043,5677547,0.698427,8129050
3,2021-07-02,18706,10484796,13301,5729171,4297,4399230,1108,356395,7956,559872,0.068873,10599,5126762,0.630672,9087,5686634,0.699545,8129050
3,2021-07-03,10208,10495004,7377,5736548,2385,4401615,446,356841,4333,558899,0.068753,5773,5132535,0.631382,4800,5691434,0.700135,8129050
3,2021-07-04,739,10495743,435,5736983,216,4401831,88,356929,287,558833,0.068745,444,5132979,0.631437,378,5691812,0.700182,8129050
3,2021-07-05,9624,10505367,7038,5744021,2159,4403990,427,357356,4323,558391,0.068691,5205,5138184,0.632077,4763,5696575,0.700768,8129050
3,2021-07-06,19336,10524703,14021,5758042,4178,4408168,1137,358493,6968,554358,0.068195,12160,5150344,0.633573,8127,5704702,0.701767,8129050
3,2021-07-07,15905,10540608,11278,5769320,3494,4411662,1133,359626,6365,552498,0.067966,9385,5159729,0.634727,7525,5712227,0.702693,8129050
3,2021-07-08,15496,10556104,11194,5780514,3288,4414950,1014,360640,6216,550634,0.067737,9116,5168845,0.635849,7252,5719479,0.703585,8129050
3,2021-07-09,17835,10573939,12454,5792968,4149,4419099,1232,361872,7375,548953,0.06753,10318,5179163,0.637118,8637,5728116,0.704648,8129050
3,2021-07-10,11037,10584976,8132,5801100,2232,4421331,673,362545,4663,548030,0.067416,6289,5185452,0.637892,5366,5733482,0.705308,8129050
3,2021-07-11,5177,10590153,3836,5804936,1062,4422393,279,362824,2337,547858,0.067395,2793,5188245,0.638235,2621,5736103,0.70563,8129050
3,2021-07-12,14433,10604586,10537,5815473,2891,4425284,1005,363829,5738,545999,0.067166,8615,5196860,0.639295,6756,5742859,0.706461,8129050
3,2021-07-13,15263,10619849,10776,5826249,3564,4428848,923,364752,6682,545155,0.067063,8471,5205331,0.640337,7627,5750486,0.7074,8129050
3,2021-07-14,14568,10634417,10345,5836594,3295,4432143,928,365680,6482,544578,0.066992,7999,5213330,0.641321,7422,5757908,0.708313,8129050
3,2021-07-15,14910,10649327,10786,5847380,3284,4435427,840,366520,6813,544258,0.066952,7993,5221323,0.642304,7673,5765581,0.709256,8129050
3,2021-07-16,17923,10667250,12871,5860251,4147,4439574,905,367425,8548,544479,0.066979,9252,5230575,0.643442,9473,5775054,0.710422,8129050
3,2021-07-17,11363,10678613,8332,5868583,2490,4442064,541,367966,5384,544527,0.066985,5896,5236471,0.644168,5944,5780998,0.711153,8129050
3,2021-07-18,5772,10684385,4356,5872939,1166,4443230,250,368216,2829,544712,0.067008,2907,5239378,0.644525,3092,5784090,0.711533,8129050
3,2021-07-19,14983,10699368,10965,5883904,3129,4446359,889,369105,7310,545324,0.067083,7586,5246964,0.645458,8198,5792288,0.712542,8129050
3,2021-07-20,16717,10716085,11642,5895546,4166,4450525,909,370014,8570,546811,0.067266,8012,5254976,0.646444,9499,5801787,0.71371,8129050
3,2021-07-21,16122,10732207,11421,5906967,3824,4454349,877,370891,8083,547927,0.067404,7864,5262840,0.647411,8980,5810767,0.714815,8129050
3,2021-07-22,16556,10748763,11702,5918669,3887,4458236,967,371858,8567,549644,0.067615,7831,5270671,0.648375,9548,5820315,0.71599,8129050
3,2021-07-23,19411,10768174,13835,5932504,4557,4462793,1019,372877,10422,552289,0.06794,8811,5279482,0.649459,11456,5831771,0.717399,8129050
3,2021-07-24,11703,10779877,8428,5940932,2687,4465480,588,373465,6446,554209,0.068176,5126,5284608,0.650089,7046,5838817,0.718266,8129050
3,2021-07-25,5702,10785579,4271,5945203,1218,4466698,213,373678,4091,556992,0.068519,1537,5286145,0.650278,4320,5843137,0.718797,8129050
3,2021-07-26,15687,10801266,10931,5956134,3774,4470472,982,374660,9461,561411,0.069062,6039,5292184,0.651021,10458,5853595,0.720084,8129050
3,2021-07-27,17668,10818934,12493,5968627,4195,4474667,980,375640,10073,565084,0.069514,7385,5299569,0.65193,11058,5864653,0.721444,8129050
3,2021-07-28,17248,10836182,12341,5980968,3855,4478522,1052,376692,9902,568910,0.069985,7130,5306699,0.652807,10956,5875609,0.722792,8129050
3,2021-07-29,17048,10853230,12267,5993235,3740,4482262,1041,377733,10025,573198,0.070512,6780,5313479,0.653641,11068,5886677,0.724153,8129050
3,2021-07-30,19794,10873024,13974,6007209,4727,4486989,1093,378826,11449,577667,0.071062,8071,5321550,0.654634,12540,5899217,0.725696,8129050
3,2021-07-31,12326,10885350,8934,6016143,2733,4489722,659,379485,7143,580490,0.071409,4988,5326538,0.655247,7811,5907028,0.726657,8129050
3,2021-08-01,6624,10891974,5047,6021190,1311,4491033,266,379751,4253,582753,0.071688,2264,5328802,0.655526,4527,5911555,0.727214,8129050
3,2021-08-02,16849,10908823,12252,6033442,3663,4494696,934,380685,10470,587957,0.072328,6205,5335007,0.656289,11409,5922964,0.728617,8129050
3,2021-08-03,18642,10927465,13447,6046889,4067,4498763,1128,381813,11091,592861,0.072931,7317,5342324,0.657189,12221,5935185,0.73012,8129050
3,2021-08-04,17847,10945312,12838,6059727,3969,4502732,1040,382853,10604,597532,0.073506,6984,5349308,0.658048,11655,5946840,0.731554,8129050
3,2021-08-05,18258,10963570,13194,6072921,3879,4506611,1185,384038,11006,602751,0.074148,6977,5356285,0.658907,12196,5959036,0.733054,8129050
3,2021-08-06,22110,10985680,16005,6088926,4924,4511535,1181,385219,13026,608240,0.074823,8730,5365015,0.659981,14219,5973255,0.734804,8129050
3,2021-08-07,12989,10998669,9642,6098568,2712,4514247,635,385854,7575,611303,0.0752,5155,5370170,0.660615,8218,5981473,0.735815,8129050
3,2021-08-08,7663,11006332,5866,6104434,1555,4515802,242,386096,4708,613427,0.075461,2841,5373011,0.660964,4965,5986438,0.736425,8129050
3,2021-08-09,18640,11024972,13966,6118400,3559,4519361,1115,387211,10483,617160,0.07592,7878,5380889,0.661933,11611,5998049,0.737854,8129050
3,2021-08-10,18988,11043960,13912,6132312,4028,4523389,1048,388259,10667,620839,0.076373,8037,5388926,0.662922,11716,6009765,0.739295,8129050
3,2021-08-11,17165,11061125,12440,6144752,3669,4527058,1056,389315,9398,623814,0.076739,7486,5396412,0.663843,10461,6020226,0.740582,8129050
3,2021-08-12,18369,11079494,12940,6157692,4295,4531353,1134,390449,10011,626920,0.077121,8051,5404463,0.664833,11157,6031383,0.741954,8129050
3,2021-08-13,23081,11102575,16371,6174063,5500,4536853,1210,391659,12529,630679,0.077583,9985,5414448,0.666062,13744,6045127,0.743645,8129050
3,2021-08-14,14966,11117541,10517,6184580,3786,4540639,663,392322,7696,632860,0.077852,6188,5420636,0.666823,8369,6053496,0.744674,8129050
3,2021-08-15,9130,11126671,6536,6191116,2300,4542939,294,392616,4479,633941,0.077985,3696,5424332,0.667277,4777,6058273,0.745262,8129050
3,2021-08-16,21067,11147738,14526,6205642,5525,4548464,1016,393632,9780,635696,0.078201,9054,5433386,0.668391,10809,6069082,0.746592,8129050
3,2021-08-17,21709,11169447,14735,6220377,5890,4554354,1084,394716,9722,637093,0.078372,9428,5442814,0.669551,10825,6079907,0.747923,8129050
3,2021-08-18,21530,11190977,14357,6234734,6137,4560491,1036,395752,9437,638452,0.07854,9143,5451957,0.670676,10502,6090409,0.749215,8129050
3,2021-08-19,21726,11212703,14354,6249088,6254,4566745,1118,396870,9164,639579,0.078678,9153,5461110,0.671802,10280,6100689,0.75048,8129050
3,2021-08-20,27357,11240060,18401,6267489,7754,4574499,1202,398072,11174,639935,0.078722,12025,5473135,0.673281,12381,6113070,0.752003,8129050
3,2021-08-21,15846,11255906,11445,6278934,3798,4578297,603,398675,6548,639861,0.078713,7240,5480375,0.674172,7166,6120236,0.752885,8129050
3,2021-08-22,8956,11264862,6380,6285314,2345,4580642,231,398906,3900,640191,0.078753,3815,5484190,0.674641,4145,6124381,0.753394,8129050
3,2021-08-23,23191,11288053,16214,6301528,6007,4586649,970,399876,9670,640756,0.078823,10093,5494283,0.675883,10658,6135039,0.754706,8129050
3,2021-08-24,23047,11311100,16586,6318114,5532,4592181,929,400805,9273,640586,0.078802,10378,5504661,0.677159,10208,6145247,0.755961,8129050
3,2021-08-25,22068,11333168,15735,6333849,5394,4597575,939,401744,8933,640603,0.078804,9869,5514530,0.678373,9886,6155133,0.757177,8129050
3,2021-08-26,22646,11355814,15948,6349797,5676,4603251,1022,402766,8851,640490,0.07879,9995,5524525,0.679603,9882,6165015,0.758393,8129050
3,2021-08-27,27779,11383593,19997,6369794,6732,4609983,1050,403816,10459,638976,0.078604,13054,5537579,0.681209,11540,6176555,0.759813,8129050
3,2021-08-28,16044,11399637,11774,6381568,3796,4613779,474,404290,6285,638048,0.07849,7700,5545279,0.682156,6772,6183327,0.760646,8129050
3,2021-08-29,9206,11408843,6839,6388407,2208,4615987,159,404449,3571,637415,0.078412,4386,5549665,0.682695,3753,6187080,0.761107,8129050
3,2021-08-30,22208,11431051,15624,6404031,5719,4621706,865,405314,8079,635890,0.078224,10484,5560149,0.683985,8959,6196039,0.762209,8129050
3,2021-08-31,21358,11452409,14803,6418834,5765,4627471,790,406104,7240,633819,0.07797,10121,5570270,0.68523,8050,6204089,0.7632,8129050
3,2021-09-01,20593,11473002,14152,6432986,5591,4633062,850,406954,7630,633179,0.077891,9141,5579411,0.686355,8501,6212590,0.764246,8129050
3,2021-09-02,20077,11493079,13549,6446535,5665,4638727,863,407817,6809,631704,0.077709,9153,5588564,0.687481,7678,6220268,0.76519,8129050
3,2021-09-03,25485,11518564,17918,6464453,6680,4645407,887,408704,8479,628556,0.077322,12534,5601098,0.689022,9386,6229654,0.766345,8129050
3,2021-09-04,13004,11531568,9578,6474031,3029,4648436,397,409101,4560,626832,0.07711,6702,5607800,0.689847,4978,6234632,0.766957,8129050
3,2021-09-05,8064,11539632,5978,6480009,1992,4650428,94,409195,3128,626183,0.07703,3881,5611681,0.690324,3232,6237864,0.767355,8129050
3,2021-09-06,4018,11543650,2681,6482690,1237,4651665,100,409295,1530,625831,0.076987,1988,5613669,0.690569,1636,6239500,0.767556,8129050
3,2021-09-07,20802,11564452,14639,6497329,5282,4656947,881,410176,6188,621348,0.076435,11568,5625237,0.691992,7085,6246585,0.768427,8129050
3,2021-09-08,18488,11582940,13001,6510330,4733,4661680,754,410930,6360,619364,0.076191,9114,5634351,0.693113,7130,6253715,0.769305,8129050
3,2021-09-09,18273,11601213,12417,6522747,5101,4666781,755,411685,6196,617393,0.075949,8931,5643282,0.694212,6960,6260675,0.770161,8129050
3,2021-09-10,22506,11623719,15581,6538328,6060,4672841,865,412550,7352,613709,0.075496,11913,5655195,0.695677,8229,6268904,0.771173,8129050
3,2021-09-11,12759,11636478,9216,6547544,3155,4675996,388,412938,4376,611561,0.075232,6926,5662121,0.696529,4778,6273682,0.771761,8129050
3,2021-09-12,7439,11643917,5322,6552866,2006,4678002,111,413049,2676,610468,0.075097,3891,5666012,0.697008,2798,6276480,0.772105,8129050
3,2021-09-13,17812,11661729,12261,6565127,4834,4682836,717,413766,5675,607262,0.074703,9617,5675629,0.698191,6411,6282891,0.772894,8129050
3,2021-09-14,16796,11678525,11783,6576910,4301,4687137,712,414478,5283,604101,0.074314,9156,5684785,0.699317,5995,6288886,0.773631,8129050
3,2021-09-15,16604,11695129,11561,6588471,4358,4691495,685,415163,5309,601010,0.073934,9086,5693871,0.700435,5995,6294881,0.774369,8129050
3,2021-09-16,16908,11712037,11517,6599988,4620,4696115,771,415934,5377,598035,0.073568,9126,5702997,0.701558,6151,6301032,0.775125,8129050
3,2021-09-17,20320,11732357,13927,6613915,5475,4701590,918,416852,6073,593656,0.073029,11360,5714357,0.702955,6981,6308013,0.775984,8129050
3,2021-09-18,11360,11743717,8199,6622114,2787,4704377,374,417226,3615,591422,0.072754,6240,5720597,0.703723,4006,6312019,0.776477,8129050
3,2021-09-19,6847,11750564,4935,6627049,1775,4706152,137,417363,2302,590256,0.072611,3621,5724218,0.704168,2455,6314474,0.776779,8129050
3,2021-09-20,16784,11767348,11652,6638701,4437,4710589,695,418058,5103,587396,0.072259,8675,5732893,0.705235,5815,6320289,0.777494,8129050
3,2021-09-21,15031,11782379,10582,6649283,3819,4714408,630,418688,4695,585208,0.07199,7516,5740409,0.70616,5328,6325617,0.77815,8129050
3,2021-09-22,14727,11797106,10457,6659740,3722,4718130,548,419236,4751,583171,0.071739,7352,5747761,0.707064,5315,6330932,0.778803,8129050
3,2021-09-23,14941,11812047,10627,6670367,3723,4721853,591,419827,4567,581488,0.071532,6849,5754610,0.707907,5166,6336098,0.779439,8129050
3,2021-09-24,24045,11836092,19170,6689537,4205,4726058,670,420497,5962,579019,0.071228,9111,5763721,0.709028,6642,6342740,0.780256,8129050
3,2021-09-25,16143,11852235,13783,6703320,2022,4728080,338,420835,3361,577752,0.071073,4975,5768696,0.70964,3708,6346448,0.780712,8129050
3,2021-09-26,9007,11861242,7955,6711275,956,4729036,96,420931,1831,576920,0.07097,2766,5771462,0.70998,1934,6348382,0.78095,8129050
3,2021-09-27,27102,11888344,23317,6734592,3193,4732229,592,421523,5083,577654,0.07106,4961,5776423,0.71059,5695,6354077,0.781651,8129050
3,2021-09-28,28459,11916803,24750,6759342,3047,4735276,662,422185,5206,577053,0.070987,6484,5782907,0.711388,5883,6359960,0.782374,8129050
3,2021-09-29,27649,11944452,24062,6783404,3027,4738303,560,422745,4849,575948,0.070851,6532,5789439,0.712191,5427,6365387,0.783042,8129050
3,2021-09-30,27527,11971979,24050,6807454,2882,4741185,595,423340,4830,574813,0.070711,6568,5796007,0.712999,5433,6370820,0.78371,8129050
3,2021-10-01,30265,12002244,26491,6833945,3213,4744398,561,423901,5356,573573,0.070558,7173,5803180,0.713882,5933,6376753,0.78444,8129050
3,2021-10-02,13560,12015804,11878,6845823,1473,4745871,209,424110,2867,572872,0.070472,3785,5806965,0.714347,3084,6379837,0.78482,8129050
3,2021-10-03,4147,12019951,3354,6849177,684,4746555,109,424219,974,572716,0.070453,1244,5808209,0.7145,1088,6380925,0.784953,8129050
4,2020-07-27,2,2,1,1,1,1,0,0,2,2,0.0,0,0,0.0,2,2,0.0,8037679
4,2020-07-28,1,3,0,1,1,2,0,0,1,3,0.0,0,0,0.0,1,3,0.0,8037679
4,2020-07-29,3,6,0,1,3,5,0,0,3,6,1e-06,0,0,0.0,3,6,1e-06,8037679
4,2020-07-31,1,7,1,2,0,5,0,0,1,7,1e-06,0,0,0.0,1,7,1e-06,8037679
4,2020-08-01,4,11,0,2,4,9,0,0,4,11,1e-06,0,0,0.0,4,11,1e-06,8037679
4,2020-08-03,5,16,0,2,5,14,0,0,4,15,2e-06,1,1,0.0,5,16,2e-06,8037679
4,2020-08-04,7,23,3,5,4,18,0,0,7,22,3e-06,0,1,0.0,7,23,3e-06,8037679
4,2020-08-05,4,27,3,8,1,19,0,0,4,26,3e-06,0,1,0.0,4,27,3e-06,8037679
4,2020-08-06,5,32,3,11,2,21,0,0,5,31,4e-06,0,1,0.0,5,32,4e-06,8037679
4,2020-08-08,2,34,2,13,0,21,0,0,2,33,4e-06,0,1,0.0,2,34,4e-06,8037679
4,2020-08-10,8,42,6,19,2,23,0,0,8,41,5e-06,0,1,0.0,8,42,5e-06,8037679
4,2020-08-11,5,47,5,24,0,23,0,0,5,46,6e-06,0,1,0.0,5,47,6e-06,8037679
4,2020-08-12,5,52,5,29,0,23,0,0,5,51,6e-06,0,1,0.0,5,52,6e-06,8037679
4,2020-08-13,8,60,6,35,2,25,0,0,8,59,7e-06,0,1,0.0,8,60,7e-06,8037679
4,2020-08-14,5,65,3,38,2,27,0,0,5,64,8e-06,0,1,0.0,5,65,8e-06,8037679
4,2020-08-15,1,66,0,38,1,28,0,0,1,65,8e-06,0,1,0.0,1,66,8e-06,8037679
4,2020-08-16,1,67,1,39,0,28,0,0,1,66,8e-06,0,1,0.0,1,67,8e-06,8037679
4,2020-08-17,9,76,6,45,3,31,0,0,9,75,9e-06,0,1,0.0,9,76,9e-06,8037679
4,2020-08-18,7,83,5,50,2,33,0,0,7,82,1e-05,0,1,0.0,7,83,1e-05,8037679
4,2020-08-19,6,89,5,55,1,34,0,0,6,88,1.1e-05,0,1,0.0,6,89,1.1e-05,8037679
4,2020-08-20,10,99,8,63,2,36,0,0,10,98,1.2e-05,0,1,0.0,10,99,1.2e-05,8037679
4,2020-08-21,18,117,16,79,2,38,0,0,16,113,1.4e-05,1,2,0.0,16,115,1.4e-05,8037679
4,2020-08-22,3,120,2,81,1,39,0,0,3,116,1.4e-05,0,2,0.0,3,118,1.5e-05,8037679
4,2020-08-23,1,121,0,81,1,40,0,0,0,115,1.4e-05,1,3,0.0,0,118,1.5e-05,8037679
4,2020-08-24,13,134,10,91,3,43,0,0,11,124,1.5e-05,2,5,1e-06,11,129,1.6e-05,8037679
4,2020-08-25,13,147,12,103,1,44,0,0,12,135,1.7e-05,1,6,1e-06,12,141,1.8e-05,8037679
4,2020-08-26,20,167,14,117,6,50,0,0,15,145,1.8e-05,5,11,1e-06,15,156,1.9e-05,8037679
4,2020-08-27,14,181,13,130,1,51,0,0,12,155,1.9e-05,2,13,2e-06,12,168,2.1e-05,8037679
4,2020-08-28,24,205,17,147,7,58,0,0,20,171,2.1e-05,4,17,2e-06,20,188,2.3e-05,8037679
4,2020-08-29,3,208,2,149,1,59,0,0,3,174,2.2e-05,0,17,2e-06,3,191,2.4e-05,8037679
4,2020-08-31,26,234,22,171,4,63,0,0,16,180,2.2e-05,10,27,3e-06,16,207,2.6e-05,8037679
4,2020-09-01,34,268,24,195,10,73,0,0,20,186,2.3e-05,14,41,5e-06,20,227,2.8e-05,8037679
4,2020-09-02,21,289,18,213,3,76,0,0,14,194,2.4e-05,6,47,6e-06,14,241,3e-05,8037679
4,2020-09-03,22,311,18,231,4,80,0,0,18,208,2.6e-05,4,51,6e-06,18,259,3.2e-05,8037679
4,2020-09-04,24,335,22,253,2,82,0,0,19,222,2.8e-05,5,56,7e-06,19,278,3.5e-05,8037679
4,2020-09-05,5,340,1,254,4,86,0,0,5,227,2.8e-05,0,56,7e-06,5,283,3.5e-05,8037679
4,2020-09-07,1,341,0,254,1,87,0,0,0,226,2.8e-05,1,57,7e-06,0,283,3.5e-05,8037679
4,2020-09-08,18,359,15,269,3,90,0,0,12,232,2.9e-05,6,63,8e-06,12,295,3.7e-05,8037679
4,2020-09-09,26,385,22,291,4,94,0,0,15,236,2.9e-05,11,74,9e-06,15,310,3.9e-05,8037679
4,2020-09-10,19,404,14,305,5,99,0,0,9,235,2.9e-05,10,84,1e-05,9,319,4e-05,8037679
4,2020-09-11,30,434,28,333,2,101,0,0,17,239,3e-05,13,97,1.2e-05,17,336,4.2e-05,8037679
4,2020-09-12,6,440,4,337,2,103,0,0,2,237,2.9e-05,4,101,1.3e-05,2,338,4.2e-05,8037679
4,2020-09-14,23,463,17,354,6,109,0,0,4,222,2.8e-05,19,120,1.5e-05,4,342,4.3e-05,8037679
4,2020-09-15,24,487,18,372,6,115,0,0,13,224,2.8e-05,11,131,1.6e-05,13,355,4.4e-05,8037679
4,2020-09-16,14,501,12,384,2,117,0,0,3,216,2.7e-05,11,142,1.8e-05,3,358,4.5e-05,8037679
4,2020-09-17,13,514,10,394,3,120,0,0,5,214,2.7e-05,7,149,1.9e-05,5,363,4.5e-05,8037679
4,2020-09-18,21,535,19,413,2,122,0,0,8,209,2.6e-05,13,162,2e-05,8,371,4.6e-05,8037679
4,2020-09-19,5,540,4,417,1,123,0,0,3,210,2.6e-05,2,164,2e-05,3,374,4.7e-05,8037679
4,2020-09-20,3,543,1,418,2,125,0,0,2,212,2.6e-05,0,164,2e-05,2,376,4.7e-05,8037679
4,2020-09-21,19,562,16,434,3,128,0,0,4,201,2.5e-05,15,179,2.2e-05,4,380,4.7e-05,8037679
4,2020-09-22,27,589,24,458,3,131,0,0,5,185,2.3e-05,22,201,2.5e-05,6,386,4.8e-05,8037679
4,2020-09-23,24,613,22,480,2,133,0,0,5,171,2.1e-05,19,220,2.7e-05,5,391,4.9e-05,8037679
4,2020-09-24,17,630,16,496,1,134,0,0,3,160,2e-05,14,234,2.9e-05,3,394,4.9e-05,8037679
4,2020-09-25,15,645,11,507,4,138,0,0,6,157,2e-05,9,243,3e-05,6,400,5e-05,8037679
4,2020-09-26,3,648,1,508,2,140,0,0,0,155,1.9e-05,2,245,3e-05,0,400,5e-05,8037679
4,2020-09-28,13,661,9,517,4,144,0,0,2,146,1.8e-05,11,256,3.2e-05,2,402,5e-05,8037679
4,2020-09-29,8,669,8,525,0,144,0,0,1,140,1.7e-05,7,263,3.3e-05,1,403,5e-05,8037679
4,2020-09-30,23,692,17,542,6,150,0,0,2,122,1.5e-05,20,283,3.5e-05,2,405,5e-05,8037679
4,2020-10-01,16,708,11,553,5,155,0,0,7,120,1.5e-05,9,292,3.6e-05,7,412,5.1e-05,8037679
4,2020-10-02,9,717,8,561,1,156,0,0,1,113,1.4e-05,8,300,3.7e-05,1,413,5.1e-05,8037679
4,2020-10-03,3,720,0,561,3,159,0,0,0,110,1.4e-05,3,303,3.8e-05,0,413,5.1e-05,8037679
4,2020-10-05,2,722,2,563,0,159,0,0,0,108,1.3e-05,2,305,3.8e-05,0,413,5.1e-05,8037679
4,2020-10-06,15,737,11,574,3,162,1,1,1,96,1.2e-05,14,319,4e-05,2,415,5.2e-05,8037679
4,2020-10-07,8,745,5,579,3,165,0,1,0,88,1.1e-05,8,327,4.1e-05,0,415,5.2e-05,8037679
4,2020-10-08,10,755,5,584,4,169,1,2,0,79,1e-05,10,337,4.2e-05,1,416,5.2e-05,8037679
4,2020-10-09,7,762,5,589,2,171,0,2,4,80,1e-05,3,340,4.2e-05,4,420,5.2e-05,8037679
4,2020-10-10,2,764,1,590,1,172,0,2,0,78,1e-05,2,342,4.3e-05,0,420,5.2e-05,8037679
4,2020-10-11,2,766,1,591,0,172,1,3,0,77,1e-05,2,344,4.3e-05,1,421,5.2e-05,8037679
4,2020-10-12,9,775,4,595,5,177,0,3,1,71,9e-06,8,352,4.4e-05,2,423,5.3e-05,8037679
4,2020-10-13,4,779,2,597,2,179,0,3,1,69,9e-06,3,355,4.4e-05,1,424,5.3e-05,8037679
4,2020-10-14,3,782,3,600,0,179,0,3,0,66,8e-06,3,358,4.5e-05,0,424,5.3e-05,8037679
4,2020-10-15,4,786,3,603,1,180,0,3,2,66,8e-06,2,360,4.5e-05,2,426,5.3e-05,8037679
4,2020-10-16,7,793,6,609,1,181,0,3,3,65,8e-06,4,364,4.5e-05,3,429,5.3e-05,8037679
4,2020-10-17,2,795,0,609,2,183,0,3,0,63,8e-06,2,366,4.6e-05,0,429,5.3e-05,8037679
4,2020-10-19,3,798,2,611,1,184,0,3,1,62,8e-06,2,368,4.6e-05,1,430,5.3e-05,8037679
4,2020-10-20,4,802,0,611,4,188,0,3,3,64,8e-06,1,369,4.6e-05,3,433,5.4e-05,8037679
4,2020-10-21,10,812,8,619,2,190,0,3,7,68,8e-06,3,372,4.6e-05,7,440,5.5e-05,8037679
4,2020-10-22,3,815,2,621,1,191,0,3,2,69,9e-06,1,373,4.6e-05,2,442,5.5e-05,8037679
4,2020-10-23,13,828,5,626,8,199,0,3,9,74,9e-06,4,377,4.7e-05,9,451,5.6e-05,8037679
4,2020-10-24,2,830,2,628,0,199,0,3,2,76,9e-06,0,377,4.7e-05,2,453,5.6e-05,8037679
4,2020-10-26,4,834,3,631,1,200,0,3,4,80,1e-05,0,377,4.7e-05,4,457,5.7e-05,8037679
4,2020-10-27,3,837,2,633,1,201,0,3,1,79,1e-05,2,379,4.7e-05,1,458,5.7e-05,8037679
4,2020-10-28,1,838,0,633,1,202,0,3,1,80,1e-05,0,379,4.7e-05,1,459,5.7e-05,8037679
4,2020-10-29,4,842,2,635,1,203,1,4,1,79,1e-05,3,382,4.8e-05,2,461,5.7e-05,8037679
4,2020-10-30,3,845,2,637,0,203,1,5,1,79,1e-05,2,384,4.8e-05,2,463,5.8e-05,8037679
4,2020-10-31,4,849,0,637,0,203,4,9,0,79,1e-05,4,388,4.8e-05,4,467,5.8e-05,8037679
4,2020-11-01,12,861,9,646,1,204,2,11,8,85,1.1e-05,4,392,4.9e-05,10,477,5.9e-05,8037679
4,2020-11-02,3,864,0,646,1,205,2,13,1,86,1.1e-05,2,394,4.9e-05,3,480,6e-05,8037679
4,2020-11-03,2,866,0,646,1,206,1,14,1,87,1.1e-05,1,395,4.9e-05,2,482,6e-05,8037679
4,2020-11-04,8,874,3,649,1,207,4,18,1,85,1.1e-05,7,402,5e-05,5,487,6.1e-05,8037679
4,2020-11-05,5,879,2,651,0,207,3,21,1,85,1.1e-05,4,406,5.1e-05,4,491,6.1e-05,8037679
4,2020-11-06,3,882,0,651,0,207,3,24,0,85,1.1e-05,3,409,5.1e-05,3,494,6.1e-05,8037679
4,2020-11-07,1,883,0,651,0,207,1,25,0,85,1.1e-05,1,410,5.1e-05,1,495,6.2e-05,8037679
4,2020-11-09,2,885,0,651,0,207,2,27,0,85,1.1e-05,2,412,5.1e-05,2,497,6.2e-05,8037679
4,2020-11-10,3,888,2,653,1,208,0,27,1,85,1.1e-05,2,414,5.2e-05,2,499,6.2e-05,8037679
4,2020-11-11,11,899,7,660,0,208,4,31,3,84,1e-05,8,422,5.3e-05,7,506,6.3e-05,8037679
4,2020-11-12,6,905,2,662,0,208,4,35,0,82,1e-05,6,428,5.3e-05,4,510,6.3e-05,8037679
4,2020-11-13,17,922,8,670,0,208,9,44,1,76,9e-06,16,444,5.5e-05,10,520,6.5e-05,8037679
4,2020-11-14,3,925,0,670,0,208,3,47,0,76,9e-06,3,447,5.6e-05,3,523,6.5e-05,8037679
4,2020-11-15,6,931,0,670,0,208,6,53,0,76,9e-06,6,453,5.6e-05,6,529,6.6e-05,8037679
4,2020-11-16,11,942,4,674,1,209,6,59,2,75,9e-06,9,462,5.7e-05,8,537,6.7e-05,8037679
4,2020-11-17,6,948,3,677,2,211,1,60,1,73,9e-06,5,467,5.8e-05,3,540,6.7e-05,8037679
4,2020-11-18,13,961,5,682,1,212,7,67,5,77,1e-05,7,474,5.9e-05,11,551,6.9e-05,8037679
4,2020-11-19,7,968,1,683,0,212,6,73,1,78,1e-05,6,480,6e-05,7,558,6.9e-05,8037679
4,2020-11-20,14,982,1,684,4,216,9,82,1,75,9e-06,14,494,6.1e-05,11,569,7.1e-05,8037679
4,2020-11-21,3,985,1,685,0,216,2,84,1,76,9e-06,2,496,6.2e-05,3,572,7.1e-05,8037679
4,2020-11-22,9,994,3,688,0,216,6,90,1,75,9e-06,8,504,6.3e-05,7,579,7.2e-05,8037679
4,2020-11-23,9,1003,2,690,1,217,6,96,2,76,9e-06,6,510,6.3e-05,7,586,7.3e-05,8037679
4,2020-11-24,17,1020,7,697,2,219,8,104,8,83,1e-05,9,519,6.5e-05,16,602,7.5e-05,8037679
4,2020-11-25,6,1026,1,698,0,219,5,109,1,84,1e-05,5,524,6.5e-05,6,608,7.6e-05,8037679
4,2020-11-26,1,1027,1,699,0,219,0,109,1,85,1.1e-05,0,524,6.5e-05,1,609,7.6e-05,8037679
4,2020-11-27,6,1033,3,702,1,220,2,111,3,87,1.1e-05,3,527,6.6e-05,5,614,7.6e-05,8037679
4,2020-11-28,5,1038,2,704,1,221,2,113,3,90,1.1e-05,2,529,6.6e-05,5,619,7.7e-05,8037679
4,2020-11-30,9,1047,4,708,2,223,3,116,6,96,1.2e-05,3,532,6.6e-05,9,628,7.8e-05,8037679
4,2020-12-01,106,1153,70,778,20,243,16,132,83,175,2.2e-05,20,552,6.9e-05,99,727,9e-05,8037679
4,2020-12-02,41,1194,28,806,6,249,7,139,32,206,2.6e-05,9,561,7e-05,40,767,9.5e-05,8037679
4,2020-12-03,31,1225,13,819,13,262,5,144,25,230,2.9e-05,6,567,7.1e-05,30,797,9.9e-05,8037679
4,2020-12-04,27,1252,7,826,5,267,15,159,12,242,3e-05,15,582,7.2e-05,27,824,0.000103,8037679
4,2020-12-05,15,1267,4,830,1,268,10,169,5,247,3.1e-05,10,592,7.4e-05,15,839,0.000104,8037679
4,2020-12-06,7,1274,6,836,1,269,0,169,7,254,3.2e-05,0,592,7.4e-05,7,846,0.000105,8037679
4,2020-12-07,29,1303,16,852,1,270,12,181,15,268,3.3e-05,14,606,7.5e-05,28,874,0.000109,8037679
4,2020-12-08,31,1334,11,863,4,274,16,197,13,279,3.5e-05,18,624,7.8e-05,29,903,0.000112,8037679
4,2020-12-09,14,1348,6,869,3,277,5,202,8,286,3.6e-05,6,630,7.8e-05,13,916,0.000114,8037679
4,2020-12-10,31,1379,10,879,4,281,17,219,15,301,3.7e-05,17,647,8e-05,32,948,0.000118,8037679
4,2020-12-11,21,1400,8,887,2,283,11,230,10,311,3.9e-05,11,658,8.2e-05,21,969,0.000121,8037679
4,2020-12-12,24,1424,18,905,6,289,0,230,23,334,4.2e-05,1,659,8.2e-05,24,993,0.000124,8037679
4,2020-12-13,12,1436,11,916,1,290,0,230,12,346,4.3e-05,0,659,8.2e-05,12,1005,0.000125,8037679
4,2020-12-14,41,1477,22,938,7,297,12,242,28,374,4.7e-05,11,670,8.3e-05,39,1044,0.00013,8037679
4,2020-12-15,527,2004,497,1435,17,314,13,255,508,876,0.000109,18,688,8.6e-05,520,1564,0.000195,8037679
4,2020-12-16,3213,5217,3200,4635,6,320,7,262,3189,4058,0.000505,18,706,8.8e-05,3200,4764,0.000593,8037679
4,2020-12-17,9244,14461,9225,13860,5,325,14,276,9203,13250,0.001648,31,737,9.2e-05,9223,13987,0.00174,8037679
4,2020-12-18,16625,31086,16609,30469,16,341,0,276,16564,29797,0.003707,34,771,9.6e-05,16581,30568,0.003803,8037679
4,2020-12-19,10530,41616,10519,40988,11,352,0,276,10437,40226,0.005005,18,789,9.8e-05,10447,41015,0.005103,8037679
4,2020-12-20,7529,49145,7511,48499,17,369,1,277,7459,47673,0.005931,20,809,0.000101,7467,48482,0.006032,8037679
4,2020-12-21,16639,65784,16602,65101,37,406,0,277,16487,64129,0.007979,54,863,0.000107,16510,64992,0.008086,8037679
4,2020-12-22,17520,83304,16713,81814,807,1213,0,277,17412,81516,0.010142,39,902,0.000112,17426,82418,0.010254,8037679
4,2020-12-23,17505,100809,14590,96404,2915,4128,0,277,17402,98884,0.012303,55,957,0.000119,17423,99841,0.012422,8037679
4,2020-12-24,8790,109599,6059,102463,2730,6858,1,278,8757,107630,0.013391,21,978,0.000122,8767,108608,0.013512,8037679
4,2020-12-25,922,110521,816,103279,106,6964,0,278,915,108542,0.013504,4,982,0.000122,916,109524,0.013626,8037679
4,2020-12-26,6362,116883,3971,107250,2391,9355,0,278,6339,114869,0.014291,15,997,0.000124,6342,115866,0.014415,8037679
4,2020-12-27,3534,120417,2032,109282,1502,10857,0,278,3513,118367,0.014727,19,1016,0.000126,3517,119383,0.014853,8037679
4,2020-12-28,15483,135900,9493,118775,5989,16846,1,279,15400,133729,0.016638,50,1066,0.000133,15412,134795,0.01677,8037679
4,2020-12-29,16183,152083,9056,127831,7127,23973,0,279,16081,149774,0.018634,59,1125,0.00014,16104,150899,0.018774,8037679
4,2020-12-30,19639,171722,11437,139268,8202,32175,0,279,19566,169307,0.021064,48,1173,0.000146,19581,170480,0.02121,8037679
4,2020-12-31,8525,180247,3436,142704,5089,37264,0,279,8471,177741,0.022113,44,1217,0.000151,8478,178958,0.022265,8037679
4,2021-01-01,1999,182246,902,143606,1069,38333,28,307,1950,179679,0.022355,42,1259,0.000157,1980,180938,0.022511,8037679
4,2021-01-02,5905,188151,3355,146961,2550,40883,0,307,5821,185428,0.02307,74,1333,0.000166,5823,186761,0.023236,8037679
4,2021-01-03,2209,190360,1305,148266,903,41786,1,308,2172,187575,0.023337,27,1360,0.000169,2174,188935,0.023506,8037679
4,2021-01-04,14130,204490,7989,156255,6139,47925,2,310,13160,199822,0.024861,928,2288,0.000285,13175,202110,0.025145,8037679
4,2021-01-05,17265,221755,10190,166445,7074,54999,1,311,14928,212470,0.026434,2287,4575,0.000569,14935,217045,0.027003,8037679
4,2021-01-06,22166,243921,13595,180040,8570,63569,1,312,15767,221920,0.02761,6324,10899,0.001356,15774,232819,0.028966,8037679
4,2021-01-07,28557,272478,17426,197466,11131,74700,0,312,16906,227316,0.028281,11525,22424,0.00279,16921,249740,0.031071,8037679
4,2021-01-08,33553,306031,21551,219017,11999,86699,3,315,18489,230886,0.028725,14937,37361,0.004648,18507,268247,0.033374,8037679
4,2021-01-09,16541,322572,9761,228778,6779,93478,1,316,9605,233605,0.029064,6895,44256,0.005506,9614,277861,0.03457,8037679
4,2021-01-10,8906,331478,5759,234537,3146,96624,1,317,4210,233178,0.029011,4643,48899,0.006084,4216,282077,0.035094,8037679
4,2021-01-11,34093,365571,22371,256908,11721,108345,1,318,19145,237541,0.029553,14802,63701,0.007925,19165,301242,0.037479,8037679
4,2021-01-12,39215,404786,22649,279557,16564,124909,2,320,24494,247516,0.030794,14539,78240,0.009734,24514,325756,0.040529,8037679
4,2021-01-13,39505,444291,19621,299178,19883,144792,1,321,27789,263739,0.032813,11575,89815,0.011174,27798,353554,0.043987,8037679
4,2021-01-14,40048,484339,15430,314608,24618,169410,0,321,32658,289177,0.035978,7239,97054,0.012075,32677,386231,0.048053,8037679
4,2021-01-15,46152,530491,16188,330796,29963,199373,1,322,40305,323793,0.040284,5709,102763,0.012785,40325,426556,0.05307,8037679
4,2021-01-16,29233,559724,9535,340331,19696,219069,2,324,25953,346559,0.043117,3197,105960,0.013183,25963,452519,0.0563,8037679
4,2021-01-17,19193,578917,6615,346946,12578,231647,0,324,17483,362391,0.045087,1662,107622,0.01339,17494,470013,0.058476,8037679
4,2021-01-18,29851,608768,13865,360811,15986,247633,0,324,23635,379975,0.047274,6070,113692,0.014145,23654,493667,0.061419,8037679
4,2021-01-19,47100,655868,23621,384432,23478,271111,1,325,37040,407121,0.050652,9919,123611,0.015379,37065,530732,0.066031,8037679
4,2021-01-20,53443,709311,28468,412900,24975,296086,0,325,42528,438921,0.054608,10761,134372,0.016718,42561,573293,0.071326,8037679
4,2021-01-21,58798,768109,26315,439215,32477,328563,6,331,51696,483688,0.060178,6973,141345,0.017585,51740,625033,0.077763,8037679
4,2021-01-22,56362,824471,22557,461772,33803,362366,2,333,50865,529262,0.065848,5318,146663,0.018247,50892,675925,0.084095,8037679
4,2021-01-23,40276,864747,17548,479320,22728,385094,0,333,35824,560714,0.069761,4395,151058,0.018794,35847,711772,0.088554,8037679
4,2021-01-24,24400,889147,10601,489921,13799,398893,0,333,22414,581196,0.072309,1945,153003,0.019036,22427,734199,0.091345,8037679
4,2021-01-25,48872,938019,22475,512396,26396,425289,1,334,37348,607151,0.075538,11420,164423,0.020457,37375,771574,0.095995,8037679
4,2021-01-26,57878,995897,29469,541865,28408,453697,1,335,45180,639768,0.079596,12582,177005,0.022022,45199,816773,0.101618,8037679
4,2021-01-27,57407,1053304,27278,569143,30129,483826,0,335,45883,674321,0.083895,11367,188372,0.023436,45920,862693,0.107331,8037679
4,2021-01-28,58215,1111519,26367,595510,31846,515672,2,337,47649,711607,0.088534,10394,198766,0.024729,47680,910373,0.113263,8037679
4,2021-01-29,57866,1169385,27700,623210,30161,545833,5,342,46997,748007,0.093063,10629,209395,0.026052,47029,957402,0.119114,8037679
4,2021-01-30,39017,1208402,17553,640763,21464,567297,0,342,33491,776062,0.096553,5456,214851,0.02673,33511,990913,0.123283,8037679
4,2021-01-31,24716,1233118,12933,653696,11781,579078,2,344,22888,797213,0.099184,1749,216600,0.026948,22900,1013813,0.126133,8037679
4,2021-02-01,50912,1284030,24521,678217,26376,605454,15,359,38643,823858,0.102499,12043,228643,0.028446,38688,1052501,0.130946,8037679
4,2021-02-02,56678,1340708,26027,704244,30649,636103,2,361,43115,853634,0.106204,13368,242011,0.03011,43144,1095645,0.136314,8037679
4,2021-02-03,63148,1403856,30909,735153,32236,668339,3,364,48160,887053,0.110362,14778,256789,0.031948,48197,1143842,0.14231,8037679
4,2021-02-04,68780,1472636,31946,767099,36832,705171,2,366,51500,921539,0.114652,17075,273864,0.034073,51561,1195403,0.148725,8037679
4,2021-02-05,74559,1547195,34437,801536,40119,745290,3,369,51514,950360,0.118238,22742,296606,0.036902,51563,1246966,0.15514,8037679
4,2021-02-06,49627,1596822,26584,828120,23042,768332,1,370,37757,976407,0.121479,11755,308361,0.038364,37802,1284768,0.159843,8037679
4,2021-02-07,27009,1623831,17836,845956,9170,777502,3,373,20333,990165,0.12319,6619,314980,0.039188,20377,1305145,0.162378,8037679
4,2021-02-08,59922,1683753,30755,876711,29163,806665,4,377,38788,1008112,0.125423,20924,335904,0.041791,38871,1344016,0.167214,8037679
4,2021-02-09,68360,1752113,34790,911501,33564,840229,6,383,39849,1019710,0.126866,28363,364267,0.04532,39961,1383977,0.172186,8037679
4,2021-02-10,78692,1830805,39352,950853,39338,879567,2,385,41100,1023656,0.127357,37310,401577,0.049962,41256,1425233,0.177319,8037679
4,2021-02-11,82871,1913676,43145,993998,39722,919289,4,389,42051,1025266,0.127557,40602,442179,0.055013,42212,1467445,0.182571,8037679
4,2021-02-12,85589,1999265,38223,1032221,47357,966646,9,398,43712,1027573,0.127844,41613,483792,0.060191,43920,1511365,0.188035,8037679
4,2021-02-13,59519,2058784,30009,1062230,29508,996154,2,400,30054,1028561,0.127967,29258,513050,0.063831,30246,1541611,0.191798,8037679
4,2021-02-14,37370,2096154,19389,1081619,17980,1014134,1,401,18952,1029362,0.128067,18327,531377,0.066111,19128,1560739,0.194178,8037679
4,2021-02-15,46965,2143119,22011,1103630,24946,1039080,8,409,23821,1030412,0.128198,23000,554377,0.068972,24050,1584789,0.19717,8037679
4,2021-02-16,81704,2224823,37498,1141128,44204,1083284,2,411,41173,1031657,0.128353,40325,594702,0.073989,41570,1626359,0.202342,8037679
4,2021-02-17,83030,2307853,39299,1180427,43726,1127010,5,416,39088,1027304,0.127811,43635,638337,0.079418,39282,1665641,0.207229,8037679
4,2021-02-18,85148,2393001,46786,1227213,38358,1165368,4,420,38860,1020366,0.126948,46000,684337,0.085141,39062,1704703,0.212089,8037679
4,2021-02-19,84283,2477284,53005,1280218,31277,1196645,1,421,41658,1019796,0.126877,42359,726696,0.090411,41789,1746492,0.217288,8037679
4,2021-02-20,50585,2527869,33647,1313865,16935,1213580,3,424,27026,1023567,0.127346,23438,750134,0.093327,27209,1773701,0.220673,8037679
4,2021-02-21,30896,2558765,24494,1338359,6399,1219979,3,427,14644,1022131,0.127167,16142,766276,0.095335,14706,1788407,0.222503,8037679
4,2021-02-22,56381,2615146,38680,1377039,17700,1237679,1,428,26950,1019930,0.126894,29240,795516,0.098973,27039,1815446,0.225867,8037679
4,2021-02-23,78173,2693319,43343,1420382,34828,1272507,2,430,34003,1010314,0.125697,43894,839410,0.104434,34278,1849724,0.230132,8037679
4,2021-02-24,93351,2786670,49299,1469681,44048,1316555,4,434,41663,1000912,0.124527,51334,890744,0.110821,41932,1891656,0.235349,8037679
4,2021-02-25,105169,2891839,55020,1524701,50147,1366702,2,436,49624,995819,0.123894,55137,945881,0.117681,50044,1941700,0.241575,8037679
4,2021-02-26,111117,3002956,56110,1580811,55001,1421703,6,442,56116,997751,0.124134,54499,1000380,0.124461,56431,1998131,0.248596,8037679
4,2021-02-27,81159,3084115,44136,1624947,37010,1458713,13,455,42582,1002295,0.1247,38293,1038673,0.129225,42837,2040968,0.253925,8037679
4,2021-02-28,50271,3134386,31026,1655973,19238,1477951,7,462,27127,1006703,0.125248,22876,1061549,0.132072,27284,2068252,0.25732,8037679
4,2021-03-01,82412,3216798,48232,1704205,34111,1512062,69,531,45198,1015427,0.126333,36790,1098339,0.136649,45514,2113766,0.262982,8037679
4,2021-03-02,92347,3309145,52981,1757186,39350,1551412,16,547,53536,1030707,0.128234,38512,1136851,0.14144,53792,2167558,0.269675,8037679
4,2021-03-03,105517,3414662,55978,1813164,49520,1600932,19,566,58386,1042658,0.129721,46742,1183593,0.147256,58693,2226251,0.276977,8037679
4,2021-03-04,104351,3519013,58224,1871388,46107,1647039,20,586,56541,1052075,0.130893,47431,1231024,0.153157,56848,2283099,0.28405,8037679
4,2021-03-05,100414,3619427,54111,1925499,45932,1692971,371,957,58407,1069511,0.133062,41663,1272687,0.15834,59099,2342198,0.291402,8037679
4,2021-03-06,78740,3698167,44234,1969733,31810,1724781,2696,3653,47722,1089378,0.135534,30763,1303450,0.162167,50630,2392828,0.297701,8037679
4,2021-03-07,46363,3744530,28252,1997985,15827,1740608,2284,5937,26931,1099475,0.13679,19288,1322738,0.164567,29385,2422213,0.301357,8037679
4,2021-03-08,70113,3814643,36656,2034641,29984,1770592,3473,9410,45642,1124503,0.139904,24284,1347022,0.167588,49312,2471525,0.307492,8037679
4,2021-03-09,84182,3898825,42541,2077182,36196,1806788,5445,14855,44991,1136210,0.14136,38894,1385916,0.172427,50601,2522126,0.313788,8037679
4,2021-03-10,94043,3992868,48359,2125541,38008,1844796,7676,22531,46840,1143933,0.142321,46950,1432866,0.178269,54673,2576799,0.32059,8037679
4,2021-03-11,103205,4096073,54062,2179603,40488,1885284,8655,31186,47088,1144010,0.142331,55772,1488638,0.185207,55849,2632648,0.327538,8037679
4,2021-03-12,106974,4203047,52499,2232102,43947,1929231,10528,41714,45088,1138170,0.141604,61560,1550198,0.192866,55720,2688368,0.334471,8037679
4,2021-03-13,83445,4286492,38422,2270524,36377,1965608,8646,50360,38585,1140942,0.141949,44578,1594776,0.198413,47350,2735718,0.340362,8037679
4,2021-03-14,50837,4337329,28793,2299317,18355,1983963,3689,54049,23414,1140831,0.141935,27289,1622065,0.201808,27178,2762896,0.343743,8037679
4,2021-03-15,85256,4422585,45858,2345175,35037,2019000,4361,58410,42959,1146298,0.142616,41971,1664036,0.207029,47438,2810334,0.349645,8037679
4,2021-03-16,109778,4532363,57176,2402351,49121,2068121,3481,61891,57357,1155129,0.143714,52105,1716141,0.213512,60936,2871270,0.357226,8037679
4,2021-03-17,109370,4641733,58856,2461207,46963,2115084,3551,65442,63472,1176665,0.146394,45575,1761716,0.219182,67111,2938381,0.365576,8037679
4,2021-03-18,109028,4750761,60444,2521651,44808,2159892,3776,69218,61166,1194149,0.148569,47525,1809241,0.225095,65009,3003390,0.373664,8037679
4,2021-03-19,113144,4863905,65030,2586681,42832,2202724,5282,74500,63655,1213965,0.151034,49177,1858418,0.231213,68993,3072383,0.382248,8037679
4,2021-03-20,85402,4949307,49955,2636636,32370,2235094,3077,77577,51851,1235606,0.153727,33342,1891760,0.235361,54983,3127366,0.389088,8037679
4,2021-03-21,48792,4998099,35362,2671998,11174,2246268,2256,79833,28339,1245938,0.155012,20294,1912054,0.237886,30626,3157992,0.392898,8037679
4,2021-03-22,83820,5081919,54655,2726653,26388,2272656,2777,82610,51514,1268222,0.157785,32055,1944109,0.241874,54339,3212331,0.399659,8037679
4,2021-03-23,106680,5188599,63898,2790551,40581,2313237,2201,84811,62080,1288237,0.160275,44339,1988448,0.247391,64354,3276685,0.407666,8037679
4,2021-03-24,115323,5303922,74352,2864903,38496,2351733,2475,87286,64065,1303929,0.162227,50913,2039361,0.253725,66605,3343290,0.415952,8037679
4,2021-03-25,119337,5423259,73439,2938342,43390,2395123,2508,89794,66541,1320572,0.164298,52471,2091832,0.260253,69114,3412404,0.424551,8037679
4,2021-03-26,121942,5545201,73897,3012239,44944,2440067,3101,92895,65390,1332913,0.165833,56209,2148041,0.267246,68550,3480954,0.433079,8037679
4,2021-03-27,93443,5638644,55052,3067291,36552,2476619,1839,94734,46862,1335319,0.166132,46354,2194395,0.273014,48760,3529714,0.439146,8037679
4,2021-03-28,56660,5695304,37447,3104738,18321,2494940,892,95626,29648,1339045,0.166596,26847,2221242,0.276354,30573,3560287,0.44295,8037679
4,2021-03-29,95441,5790745,57117,3161855,36207,2531147,2117,97743,50580,1347174,0.167607,44650,2265892,0.281909,52779,3613066,0.449516,8037679
4,2021-03-30,119254,5909999,65129,3226984,49893,2581040,4232,101975,69393,1371245,0.170602,49617,2315509,0.288082,73688,3686754,0.458684,8037679
4,2021-03-31,122934,6032933,72511,3299495,44028,2625068,6395,108370,68059,1391099,0.173072,54630,2370139,0.294879,74484,3761238,0.467951,8037679
4,2021-04-01,144894,6177827,82513,3382008,48856,2673924,13525,121895,83987,1428135,0.17768,60490,2430629,0.302404,97526,3858764,0.480084,8037679
4,2021-04-02,138542,6316369,74050,3456058,50764,2724688,13728,135623,78839,1461328,0.18181,59421,2490050,0.309797,92614,3951378,0.491607,8037679
4,2021-04-03,102165,6418534,54598,3510656,34006,2758694,13561,149184,52639,1478246,0.183915,49310,2539360,0.315932,66228,4017606,0.499847,8037679
4,2021-04-04,47319,6465853,24990,3535646,14762,2773456,7567,156751,20063,1478744,0.183976,27153,2566513,0.31931,27651,4045257,0.503287,8037679
4,2021-04-05,111730,6577583,62621,3598267,36043,2809499,13066,169817,56945,1494249,0.185906,54570,2621083,0.326099,70075,4115332,0.512005,8037679
4,2021-04-06,140656,6718239,79128,3677395,41491,2850990,20037,189854,71960,1517873,0.188845,68418,2689501,0.334612,92042,4207374,0.523456,8037679
4,2021-04-07,139541,6857780,79050,3756445,39516,2890506,20975,210829,71364,1542332,0.191888,67927,2757428,0.343063,92386,4299760,0.53495,8037679
4,2021-04-08,141960,6999740,79063,3835508,37126,2927632,25771,236600,69886,1566223,0.19486,71793,2829221,0.351995,95684,4395444,0.546855,8037679
4,2021-04-09,139390,7139130,76332,3911840,39743,2967375,23315,259915,65847,1582131,0.196839,73273,2902494,0.361111,89181,4484625,0.55795,8037679
4,2021-04-10,105137,7244267,51784,3963624,34225,3001600,19128,279043,46977,1590342,0.197861,57940,2960434,0.36832,66151,4550776,0.56618,8037679
4,2021-04-11,63276,7307543,38415,4002039,13565,3015165,11296,290339,27321,1593172,0.198213,35828,2996262,0.372777,38658,4589434,0.57099,8037679
4,2021-04-12,104170,7411713,63210,4065249,30575,3045740,10385,300724,51987,1603747,0.199529,51860,3048122,0.379229,62435,4651869,0.578758,8037679
4,2021-04-13,131770,7543483,82637,4147886,48961,3094701,172,300896,78137,1628865,0.202654,53303,3101425,0.385861,78421,4730290,0.588514,8037679
4,2021-04-14,137232,7680715,87548,4235434,49603,3144304,81,300977,75355,1642928,0.204403,61501,3162926,0.393512,75564,4805854,0.597916,8037679
4,2021-04-15,157684,7838399,104747,4340181,52852,3197156,85,301062,95825,1677639,0.208722,61324,3224250,0.401142,96035,4901889,0.609864,8037679
4,2021-04-16,144861,7983260,91775,4431956,53000,3250156,86,301148,83373,1700113,0.211518,61088,3285338,0.408742,83562,4985451,0.62026,8037679
4,2021-04-17,102303,8085563,64242,4496198,38033,3288189,28,301176,59467,1717205,0.213644,42528,3327866,0.414033,59620,5045071,0.627678,8037679
4,2021-04-18,57800,8143363,39182,4535380,18613,3306802,5,301181,32238,1724126,0.214505,25390,3353256,0.417192,32311,5077382,0.631698,8037679
4,2021-04-19,101859,8245222,67052,4602432,34783,3341585,24,301205,51015,1724817,0.214591,50434,3403690,0.423467,51125,5128507,0.638058,8037679
4,2021-04-20,132302,8377524,78771,4681203,53505,3395090,26,301231,67818,1728891,0.215098,63913,3467603,0.431418,67987,5196494,0.646517,8037679
4,2021-04-21,135633,8513157,88471,4769674,47092,3442182,70,301301,67635,1729234,0.215141,67519,3535122,0.439819,67862,5264356,0.65496,8037679
4,2021-04-22,142836,8655993,94783,4864457,48026,3490208,27,301328,63160,1713339,0.213163,79249,3614371,0.449678,63354,5327710,0.662842,8037679
4,2021-04-23,136175,8792168,88622,4953079,47527,3537735,26,301354,58359,1694474,0.210816,77400,3691771,0.459308,58535,5386245,0.670124,8037679
4,2021-04-24,99609,8891777,67175,5020254,32379,3570114,55,301409,45340,1686175,0.209784,53841,3745612,0.466007,45542,5431787,0.67579,8037679
4,2021-04-25,50760,8942537,35783,5056037,14949,3585063,28,301437,26251,1688192,0.210035,24345,3769957,0.469036,26362,5458149,0.67907,8037679
4,2021-04-26,92919,9035456,60928,5116965,31574,3616637,417,301854,36146,1668433,0.207576,56456,3826413,0.476059,36697,5494846,0.683636,8037679
4,2021-04-27,114892,9150348,70226,5187191,42326,3658963,2340,304194,40898,1638154,0.203809,73648,3900061,0.485222,43369,5538215,0.689032,8037679
4,2021-04-28,105580,9255928,68940,5256131,34078,3693041,2562,306756,38098,1611838,0.200535,67105,3967166,0.493571,40789,5579004,0.694106,8037679
4,2021-04-29,107292,9363220,68429,5324560,36294,3729335,2569,309325,34102,1575795,0.196051,72839,4040005,0.502633,36796,5615800,0.698684,8037679
4,2021-04-30,107196,9470416,67669,5392229,36762,3766097,2765,312090,36008,1543902,0.192083,70791,4110796,0.511441,38898,5654698,0.703524,8037679
4,2021-05-01,70968,9541384,46875,5439104,22259,3788356,1834,313924,20533,1516262,0.188644,50102,4160898,0.517674,22462,5677160,0.706318,8037679
4,2021-05-02,38055,9579439,27004,5466108,9722,3798078,1329,315253,10470,1500646,0.186701,27449,4188347,0.521089,11833,5688993,0.707791,8037679
4,2021-05-03,80023,9659462,55793,5521901,21711,3819789,2519,317772,19044,1461596,0.181843,60701,4249048,0.528641,21651,5710644,0.710484,8037679
4,2021-05-04,102189,9761651,69896,5591797,29486,3849275,2807,320579,22488,1407605,0.175126,79362,4328410,0.538515,25371,5736015,0.713641,8037679
4,2021-05-05,102989,9864640,72560,5664357,27656,3876931,2773,323352,21610,1351002,0.168084,81062,4409472,0.5486,24459,5760474,0.716684,8037679
4,2021-05-06,112810,9977450,84487,5748844,25353,3902284,2970,326322,19357,1280353,0.159294,93061,4502533,0.560178,22412,5782886,0.719472,8037679
4,2021-05-07,105747,10083197,75938,5824782,27105,3929389,2704,329026,20438,1218676,0.15162,84922,4587455,0.570744,23245,5806131,0.722364,8037679
4,2021-05-08,70401,10153598,48512,5873294,19931,3949320,1958,330984,13618,1177830,0.146539,56526,4643981,0.577776,15680,5821811,0.724315,8037679
4,2021-05-09,34765,10188363,28419,5901713,5385,3954705,961,331945,7225,1158618,0.144148,27425,4671406,0.581188,8213,5830024,0.725337,8037679
4,2021-05-10,65806,10254169,44045,5945758,19408,3974113,2353,334298,10928,1117321,0.13901,54648,4726054,0.587987,13351,5843375,0.726998,8037679
4,2021-05-11,83969,10338138,52576,5998334,29181,4003294,2212,336510,15591,1067114,0.132764,68096,4794150,0.59646,17889,5861264,0.729223,8037679
4,2021-05-12,80343,10418481,53398,6051732,24458,4027752,2487,338997,16460,1022551,0.12722,63588,4857738,0.604371,19025,5880289,0.73159,8037679
4,2021-05-13,105498,10523979,77566,6129298,26383,4054135,1549,340546,40529,1000098,0.124426,64626,4922364,0.612411,42173,5922462,0.736837,8037679
4,2021-05-14,105993,10629972,74675,6203973,29145,4083280,2173,342719,40507,977735,0.121644,65119,4987483,0.620513,42756,5965218,0.742157,8037679
4,2021-05-15,86471,10716443,66776,6270749,18342,4101622,1353,344072,37872,968742,0.120525,48278,5035761,0.626519,39285,6004503,0.747044,8037679
4,2021-05-16,52125,10768568,41965,6312714,9437,4111059,723,344795,20905,959364,0.119358,31053,5066814,0.630383,21675,6026178,0.749741,8037679
4,2021-05-17,71830,10840398,52438,6365152,17533,4128592,1859,346654,28196,946076,0.117705,43409,5110223,0.635783,30121,6056299,0.753489,8037679
4,2021-05-18,82525,10922923,53580,6418732,27165,4155757,1780,348434,29281,924344,0.115001,52867,5163090,0.642361,31135,6087434,0.757362,8037679
4,2021-05-19,77593,11000516,52423,6471155,23180,4178937,1990,350424,30985,911096,0.113353,46290,5209380,0.64812,33042,6120476,0.761473,8037679
4,2021-05-20,69653,11070169,44784,6515939,22847,4201784,2022,352446,25605,895094,0.111362,43730,5253110,0.653561,27728,6148204,0.764923,8037679
4,2021-05-21,74608,11144777,49162,6565101,23536,4225320,1910,354356,26167,875108,0.108876,48113,5301223,0.659546,28127,6176331,0.768422,8037679
4,2021-05-22,50344,11195121,35310,6600411,13750,4239070,1284,355640,21663,869682,0.108201,28455,5329678,0.663087,23029,6199360,0.771287,8037679
4,2021-05-23,24089,11219210,17178,6617589,6183,4245253,728,356368,9705,865898,0.10773,14255,5343933,0.66486,10471,6209831,0.77259,8037679
4,2021-05-24,43530,11262740,27679,6645268,12809,4258062,3042,359410,15131,855961,0.106494,28156,5372089,0.668363,18219,6228050,0.774857,8037679
4,2021-05-25,45409,11308149,28236,6673504,14326,4272388,2847,362257,15986,845677,0.105214,29154,5401243,0.67199,18870,6246920,0.777204,8037679
4,2021-05-26,45151,11353300,27039,6700543,15447,4287835,2665,364922,15937,835340,0.103928,28966,5430209,0.675594,18629,6265549,0.779522,8037679
4,2021-05-27,39324,11392624,23576,6724119,12579,4300414,3169,368091,14673,828780,0.103112,24428,5454637,0.678633,17868,6283417,0.781745,8037679
4,2021-05-28,43817,11436441,27867,6751986,14314,4314728,1636,369727,18843,824652,0.102598,24658,5479295,0.681701,20530,6303947,0.784299,8037679
4,2021-05-29,23912,11460353,15518,6767504,7453,4322181,941,370668,10798,823488,0.102453,12940,5492235,0.683311,11776,6315723,0.785765,8037679
4,2021-05-30,12173,11472526,8546,6776050,3089,4325270,538,371206,4985,821922,0.102259,7106,5499341,0.684195,5540,6321263,0.786454,8037679
4,2021-05-31,3695,11476221,2355,6778405,1177,4326447,163,371369,1164,820792,0.102118,2463,5501804,0.684502,1333,6322596,0.78662,8037679
4,2021-06-01,39888,11516109,24786,6803191,12632,4339079,2470,373839,13008,809737,0.100743,26590,5528394,0.68781,15535,6338131,0.788552,8037679
4,2021-06-02,32999,11549108,20611,6823802,9563,4348642,2825,376664,10957,801684,0.099741,21865,5550259,0.69053,13812,6351943,0.790271,8037679
4,2021-06-03,48687,11597795,37362,6861164,8834,4357476,2491,379155,10391,776556,0.096614,38087,5588346,0.695269,12959,6364902,0.791883,8037679
4,2021-06-04,55479,11653274,44661,6905825,9475,4366951,1343,380498,12818,748514,0.093126,42375,5630721,0.700541,14333,6379235,0.793666,8037679
4,2021-06-05,45261,11698535,38770,6944595,5482,4372433,1009,381507,8719,721992,0.089826,36342,5667063,0.705062,9820,6389055,0.794888,8037679
4,2021-06-06,21371,11719906,19062,6963657,1735,4374168,574,382081,3810,709089,0.088221,17387,5684450,0.707225,4484,6393539,0.795446,8037679
4,2021-06-07,39074,11758980,31587,6995244,5522,4379690,1965,384046,8446,689080,0.085731,30494,5714944,0.711019,10485,6404024,0.79675,8037679
4,2021-06-08,40850,11799830,32031,7027275,6258,4385948,2561,386607,9415,669898,0.083345,31245,5746189,0.714907,12063,6416087,0.798251,8037679
4,2021-06-09,39176,11839006,31039,7058314,5751,4391699,2386,388993,7874,649110,0.080758,31109,5777298,0.718777,10321,6426408,0.799535,8037679
4,2021-06-10,37414,11876420,29463,7087777,5318,4397017,2633,391626,8401,631368,0.078551,28837,5806135,0.722365,11095,6437503,0.800916,8037679
4,2021-06-11,38673,11915093,30341,7118118,6311,4403328,2021,393647,9887,614785,0.076488,28600,5834735,0.725923,12017,6449520,0.802411,8037679
4,2021-06-12,26919,11942012,22359,7140477,3799,4407127,761,394408,6069,600942,0.074766,20737,5855472,0.728503,6894,6456414,0.803268,8037679
4,2021-06-13,10920,11952932,8626,7149103,1813,4408940,481,394889,2235,595072,0.074035,8625,5864097,0.729576,2755,6459169,0.803611,8037679
4,2021-06-14,28847,11981779,21572,7170675,4454,4413394,2821,397710,7789,584824,0.07276,20899,5884996,0.732176,10651,6469820,0.804936,8037679
4,2021-06-15,30266,12012045,21424,7192099,5425,4418819,3417,401127,8325,574868,0.071522,21748,5906744,0.734882,11792,6481612,0.806403,8037679
4,2021-06-16,26915,12038960,20297,7212396,3985,4422804,2633,403760,8059,566970,0.070539,18633,5925377,0.7372,10735,6492347,0.807739,8037679
4,2021-06-17,25387,12064347,18750,7231146,3719,4426523,2918,406678,7644,560033,0.069676,17525,5942902,0.73938,10588,6502935,0.809056,8037679
4,2021-06-18,26896,12091243,21199,7252345,4458,4430981,1239,407917,8240,551122,0.068567,18465,5961367,0.741678,9554,6512489,0.810245,8037679
4,2021-06-19,15873,12107116,12843,7265188,2315,4433296,715,408632,5055,546291,0.067966,10667,5972034,0.743005,5836,6518325,0.810971,8037679
4,2021-06-20,7402,12114518,6090,7271278,1005,4434301,307,408939,2604,544514,0.067745,4719,5976753,0.743592,2942,6521267,0.811337,8037679
4,2021-06-21,14668,12129186,10595,7281873,2921,4437222,1152,410091,7300,545759,0.0679,7249,5984002,0.744494,8494,6529761,0.812394,8037679
4,2021-06-22,20573,12149759,16033,7297906,3456,4440678,1084,411175,7054,540574,0.067255,13373,5997375,0.746158,8188,6537949,0.813413,8037679
4,2021-06-23,18548,12168307,14542,7312448,2997,4443675,1009,412184,6713,536635,0.066765,11693,6009068,0.747612,7754,6545703,0.814377,8037679
4,2021-06-24,17728,12186035,13712,7326160,3027,4446702,989,413173,6563,533231,0.066341,10988,6020056,0.748979,7584,6553287,0.815321,8037679
4,2021-06-25,21763,12207798,17100,7343260,3602,4450304,1061,414234,7839,528419,0.065743,13762,6033818,0.750692,8950,6562237,0.816434,8037679
4,2021-06-26,13172,12220970,10732,7353992,1820,4452124,620,414854,4825,525727,0.065408,8186,6042004,0.75171,5494,6567731,0.817118,8037679
4,2021-06-27,6943,12227913,5627,7359619,971,4453095,345,415199,2916,525081,0.065327,3922,6045926,0.752198,3276,6571007,0.817525,8037679
4,2021-06-28,15233,12243146,12782,7372401,1588,4454683,863,416062,6084,523065,0.065077,8992,6054918,0.753317,6976,6577983,0.818393,8037679
4,2021-06-29,16636,12259782,12912,7385313,2906,4457589,818,416880,6407,520330,0.064736,9993,6064911,0.75456,7258,6585241,0.819296,8037679
4,2021-06-30,14757,12274539,11511,7396824,2506,4460095,740,417620,6100,518811,0.064547,8400,6073311,0.755605,6881,6592122,0.820152,8037679
4,2021-07-01,14744,12289283,11595,7408419,2391,4462486,758,418378,6031,517178,0.064344,8459,6081770,0.756657,6826,6598948,0.821002,8037679
4,2021-07-02,17078,12306361,13531,7421950,2767,4465253,780,419158,6957,515038,0.064078,9909,6091679,0.75789,7769,6606717,0.821968,8037679
4,2021-07-03,9307,12315668,7396,7429346,1495,4466748,416,419574,4003,514308,0.063987,5170,6096849,0.758534,4440,6611157,0.822521,8037679
4,2021-07-04,449,12316117,281,7429627,107,4466855,61,419635,197,514325,0.063989,244,6097093,0.758564,261,6611418,0.822553,8037679
4,2021-07-05,9309,12325426,7566,7437193,1326,4468181,417,420052,4226,514040,0.063954,4942,6102035,0.759179,4657,6616075,0.823133,8037679
4,2021-07-06,16684,12342110,13138,7450331,2731,4470912,815,420867,6119,510598,0.063526,10394,6112429,0.760472,6952,6623027,0.823997,8037679
4,2021-07-07,13869,12355979,10820,7461151,2266,4473178,783,421650,5184,508065,0.06321,8523,6120952,0.761532,5990,6629017,0.824743,8037679
4,2021-07-08,13373,12369352,10428,7471579,2096,4475274,849,422499,5231,506147,0.062972,8004,6128956,0.762528,6086,6635103,0.8255,8037679
4,2021-07-09,15594,12384946,11961,7483540,2693,4477967,940,423439,6323,504366,0.06275,9064,6138020,0.763656,7283,6642386,0.826406,8037679
4,2021-07-10,8959,12393905,7091,7490631,1461,4479428,407,423846,3763,503451,0.062636,5106,6143126,0.764291,4191,6646577,0.826927,8037679
4,2021-07-11,5004,12398909,4002,7494633,801,4480229,201,424047,2245,503191,0.062604,2712,6145838,0.764628,2452,6649029,0.827232,8037679
4,2021-07-12,13173,12412082,10424,7505057,2014,4482243,735,424782,5087,501027,0.062335,7998,6153836,0.765624,5834,6654863,0.827958,8037679
4,2021-07-13,12943,12425025,9900,7514957,2399,4484642,644,425426,5497,499865,0.06219,7327,6161163,0.766535,6165,6661028,0.828725,8037679
4,2021-07-14,11877,12436902,9337,7524294,1975,4486617,565,425991,5133,498943,0.062076,6629,6167792,0.76736,5707,6666735,0.829435,8037679
4,2021-07-15,12556,12449458,9951,7534245,2001,4488618,604,426595,5693,498526,0.062024,6740,6174532,0.768198,6323,6673058,0.830222,8037679
4,2021-07-16,15147,12464605,11812,7546057,2665,4491283,670,427265,6951,498122,0.061973,8053,6182585,0.7692,7649,6680707,0.831174,8037679
4,2021-07-17,9433,12474038,7452,7553509,1648,4492931,333,427598,4440,498014,0.06196,4888,6187473,0.769808,4780,6685487,0.831768,8037679
4,2021-07-18,5411,12479449,4356,7557865,855,4493786,200,427798,2541,497950,0.061952,2813,6190286,0.770158,2749,6688236,0.83211,8037679
4,2021-07-19,12897,12492346,10224,7568089,2014,4495800,659,428457,6114,498082,0.061968,6661,6196947,0.770987,6793,6695029,0.832956,8037679
4,2021-07-20,13985,12506331,10764,7578853,2545,4498345,676,429133,6910,498786,0.062056,6901,6203848,0.771846,7605,6702634,0.833902,8037679
4,2021-07-21,12935,12519266,10037,7588890,2245,4500590,653,429786,6424,499637,0.062162,6242,6210090,0.772622,7093,6709727,0.834784,8037679
4,2021-07-22,13665,12532931,10672,7599562,2322,4502912,671,430457,7095,501083,0.062342,6326,6216416,0.773409,7772,6717499,0.835751,8037679
4,2021-07-23,15908,12548839,12248,7611810,2947,4505859,713,431170,8291,502785,0.062554,7329,6223745,0.774321,9031,6726530,0.836875,8037679
4,2021-07-24,9671,12558510,7559,7619369,1777,4507636,335,431505,4974,503601,0.062655,4507,6228252,0.774882,5323,6731853,0.837537,8037679
4,2021-07-25,4829,12563339,3789,7623158,878,4508514,162,431667,3391,505835,0.062933,1324,6229576,0.775047,3558,6735411,0.83798,8037679
4,2021-07-26,13175,12576514,10304,7633462,2175,4510689,696,432363,7615,508855,0.063309,5296,6234872,0.775706,8316,6743727,0.839014,8037679
4,2021-07-27,14534,12591048,11136,7644598,2627,4513316,771,433134,7796,510975,0.063572,6453,6241325,0.776508,8573,6752300,0.840081,8037679
4,2021-07-28,13360,12604408,10182,7654780,2472,4515788,706,433840,7366,513367,0.06387,5698,6247023,0.777217,8090,6760390,0.841087,8037679
4,2021-07-29,13652,12618060,10592,7665372,2331,4518119,729,434569,7597,515994,0.064197,5709,6252732,0.777928,8336,6768726,0.842124,8037679
4,2021-07-30,15967,12634027,12205,7677577,2947,4521066,815,435384,8608,518616,0.064523,6809,6259541,0.778775,9431,6778157,0.843298,8037679
4,2021-07-31,9847,12643874,7670,7685247,1749,4522815,428,435812,5517,520561,0.064765,4000,6263541,0.779272,5945,6784102,0.844037,8037679
4,2021-08-01,5535,12649409,4560,7689807,799,4523614,176,435988,3236,521870,0.064928,2115,6265656,0.779535,3424,6787526,0.844463,8037679
4,2021-08-02,14268,12663677,11376,7701183,2138,4525752,754,436742,8278,525274,0.065351,5636,6271292,0.780237,9040,6796566,0.845588,8037679
4,2021-08-03,14871,12678548,11414,7712597,2673,4528425,784,437526,8513,528603,0.065766,5985,6277277,0.780981,9314,6805880,0.846747,8037679
4,2021-08-04,13574,12692122,10575,7723172,2294,4530719,705,438231,7629,531507,0.066127,5431,6282708,0.781657,8335,6814215,0.847784,8037679
4,2021-08-05,14549,12706671,11473,7734645,2294,4533013,782,439013,8126,534624,0.066515,5795,6288503,0.782378,8912,6823127,0.848893,8037679
4,2021-08-06,17464,12724135,13395,7748040,3186,4536199,883,439896,9680,538092,0.066946,7106,6295609,0.783262,10574,6833701,0.850208,8037679
4,2021-08-07,10326,12734461,8215,7756255,1667,4537866,444,440340,5604,539889,0.06717,4256,6299865,0.783792,6053,6839754,0.850961,8037679
4,2021-08-08,6294,12740755,5003,7761258,1087,4538953,204,440544,3600,541234,0.067337,2465,6302330,0.784098,3810,6843564,0.851435,8037679
4,2021-08-09,14888,12755643,12052,7773310,2074,4541027,762,441306,7940,543540,0.067624,6395,6308725,0.784894,8701,6852265,0.852518,8037679
4,2021-08-10,15117,12770760,11624,7784934,2712,4543739,781,442087,7945,545590,0.067879,6681,6315406,0.785725,8731,6860996,0.853604,8037679
4,2021-08-11,13054,12783814,9995,7794929,2274,4546013,785,442872,6682,547159,0.068074,5899,6321305,0.786459,7468,6868464,0.854533,8037679
4,2021-08-12,14323,12798137,10888,7805817,2656,4548669,779,443651,7307,548833,0.068283,6417,6327722,0.787257,8091,6876555,0.85554,8037679
4,2021-08-13,18153,12816290,13433,7819250,3808,4552477,912,444563,8885,550430,0.068481,8213,6335935,0.788279,9810,6886365,0.85676,8037679
4,2021-08-14,12459,12828749,8879,7828129,3046,4555523,534,445097,5562,551620,0.068629,4926,6340861,0.788892,6116,6892481,0.857521,8037679
4,2021-08-15,8232,12836981,5974,7834103,2034,4557557,224,445321,3478,552158,0.068696,3185,6344046,0.789288,3723,6896204,0.857985,8037679
4,2021-08-16,18457,12855438,12767,7846870,4799,4562356,891,446212,7353,552958,0.068796,7449,6351495,0.790215,8249,6904453,0.859011,8037679
4,2021-08-17,18762,12874200,12755,7859625,5127,4567483,880,447092,7133,553521,0.068866,7462,6358957,0.791143,8025,6912478,0.860009,8037679
4,2021-08-18,18329,12892529,12335,7871960,5190,4572673,804,447896,6577,553983,0.068923,6935,6365892,0.792006,7397,6919875,0.86093,8037679
4,2021-08-19,18765,12911294,12493,7884453,5464,4578137,808,448704,6551,554551,0.068994,6796,6372688,0.792852,7364,6927239,0.861846,8037679
4,2021-08-20,23735,12935029,16039,7900492,6834,4584971,862,449566,7980,554239,0.068955,9160,6381848,0.793991,8848,6936087,0.862947,8037679
4,2021-08-21,14883,12949912,10378,7910870,4091,4589062,414,449980,4769,553663,0.068883,5768,6387616,0.794709,5192,6941279,0.863592,8037679
4,2021-08-22,8799,12958711,6215,7917085,2422,4591484,162,450142,3298,553967,0.068921,3171,6390787,0.795104,3475,6944754,0.864025,8037679
4,2021-08-23,20778,12979489,14634,7931719,5425,4596909,719,450861,7172,553851,0.068907,8020,6398807,0.796101,7904,6952658,0.865008,8037679
4,2021-08-24,20083,12999572,14181,7945900,5218,4602127,684,451545,6650,553329,0.068842,7876,6406683,0.797081,7354,6960012,0.865923,8037679
4,2021-08-25,18588,13018160,13140,7959040,4803,4606930,645,452190,6303,553245,0.068831,7057,6413740,0.797959,6973,6966985,0.866791,8037679
4,2021-08-26,19086,13037246,13466,7972506,4974,4611904,646,452836,6152,552625,0.068754,7413,6421153,0.798881,6793,6973778,0.867636,8037679
4,2021-08-27,23485,13060731,16743,7989249,6042,4617946,700,453536,7343,550946,0.068545,9729,6430882,0.800092,8050,6981828,0.868637,8037679
4,2021-08-28,14439,13075170,10322,7999571,3737,4621683,380,453916,4559,549963,0.068423,5940,6436822,0.800831,4957,6986785,0.869254,8037679
4,2021-08-29,8547,13083717,6111,8005682,2329,4624012,107,454023,2787,549393,0.068352,3479,6440301,0.801264,2909,6989694,0.869616,8037679
4,2021-08-30,19231,13102948,13439,8019121,5152,4629164,640,454663,5769,547981,0.068177,7834,6448135,0.802238,6422,6996116,0.870415,8037679
4,2021-08-31,19186,13122134,13101,8032222,5523,4634687,562,455225,5248,546224,0.067958,7573,6455708,0.803181,5816,7001932,0.871139,8037679
4,2021-09-01,17469,13139603,11981,8044203,4969,4639656,519,455744,5213,545644,0.067886,6318,6462026,0.803967,5738,7007670,0.871852,8037679
4,2021-09-02,17530,13157133,11970,8056173,5023,4644679,537,456281,4870,544551,0.06775,6509,6468535,0.804776,5416,7013086,0.872526,8037679
4,2021-09-03,21585,13178718,14909,8071082,6010,4650689,666,456947,6053,542190,0.067456,9110,6477645,0.80591,6749,7019835,0.873366,8037679
4,2021-09-04,11677,13190395,8448,8079530,2940,4653629,289,457236,3411,540678,0.067268,5225,6482870,0.80656,3713,7023548,0.873828,8037679
4,2021-09-05,7573,13197968,5417,8084947,2063,4655692,93,457329,2400,540067,0.067192,3112,6485982,0.806947,2501,7026049,0.874139,8037679
4,2021-09-06,2752,13200720,1798,8086745,899,4656591,55,457384,967,539941,0.067176,1148,6487130,0.80709,1022,7027071,0.874266,8037679
4,2021-09-07,18047,13218767,12834,8099579,4675,4661266,538,457922,4572,536632,0.066765,8425,6495555,0.808138,5116,7032187,0.874903,8037679
4,2021-09-08,15550,13234317,10964,8110543,4102,4665368,484,458406,4449,535151,0.06658,6420,6501975,0.808937,4939,7037126,0.875517,8037679
4,2021-09-09,15261,13249578,10404,8120947,4286,4669654,571,458977,4295,533854,0.066419,6172,6508147,0.809705,4875,7042001,0.876124,8037679
4,2021-09-10,18957,13268535,13096,8134043,5245,4674899,616,459593,5311,531320,0.066104,8469,6516616,0.810758,5935,7047936,0.876862,8037679
4,2021-09-11,10641,13279176,7585,8141628,2779,4677678,277,459870,3203,529903,0.065927,4910,6521526,0.811369,3493,7051429,0.877297,8037679
4,2021-09-12,6382,13285558,4644,8146272,1660,4679338,78,459948,2012,529105,0.065828,2901,6524427,0.81173,2103,7053532,0.877558,8037679
4,2021-09-13,14723,13300281,10130,8156402,4127,4683465,466,460414,3991,526724,0.065532,6851,6531278,0.812583,4470,7058002,0.878114,8037679
4,2021-09-14,13626,13313907,9427,8165829,3664,4687129,535,460949,3664,524431,0.065247,6499,6537777,0.813391,4206,7062208,0.878638,8037679
4,2021-09-15,13335,13327242,9272,8175101,3552,4690681,511,461460,3710,522333,0.064986,6326,6544103,0.814178,4228,7066436,0.879164,8037679
4,2021-09-16,13350,13340592,9134,8184235,3642,4694323,574,462034,3848,520693,0.064782,6072,6550175,0.814934,4432,7070868,0.879715,8037679
4,2021-09-17,16478,13357070,11372,8195607,4465,4698788,641,462675,4316,517949,0.06444,7718,6557893,0.815894,4974,7075842,0.880334,8037679
4,2021-09-18,9822,13366892,7127,8202734,2429,4701217,266,462941,2760,516533,0.064264,4446,6562339,0.816447,3030,7078872,0.880711,8037679
4,2021-09-19,6274,13373166,4523,8207257,1665,4702882,86,463027,1715,515601,0.064148,2742,6565081,0.816788,1810,7080682,0.880936,8037679
4,2021-09-20,14565,13387731,10115,8217372,3907,4706789,543,463570,3747,514014,0.063951,5889,6570970,0.817521,4302,7084984,0.881471,8037679
4,2021-09-21,12945,13400676,8972,8226344,3389,4710178,584,464154,3409,512764,0.063795,5233,6576203,0.818172,3983,7088967,0.881967,8037679
4,2021-09-22,12100,13412776,8585,8234929,3145,4713323,370,464524,3308,511589,0.063649,4856,6581059,0.818776,3681,7092648,0.882425,8037679
4,2021-09-23,12997,13425773,9510,8244439,3067,4716390,420,464944,3327,510748,0.063544,4584,6585643,0.819346,3743,7096391,0.882891,8037679
4,2021-09-24,24190,13449963,20012,8264451,3710,4720100,468,465412,4513,509241,0.063357,6499,6592142,0.820155,4992,7101383,0.883512,8037679
4,2021-09-25,16606,13466569,14682,8279133,1700,4721800,224,465636,2721,508709,0.063291,3490,6595632,0.820589,2958,7104341,0.88388,8037679
4,2021-09-26,10259,13476828,9297,8288430,911,4722711,51,465687,1519,508283,0.063238,2005,6597637,0.820839,1579,7105920,0.884076,8037679
4,2021-09-27,30278,13507106,26970,8315400,2860,4725571,448,466135,4201,509355,0.063371,3600,6601237,0.821286,4672,7110592,0.884657,8037679
4,2021-09-28,30171,13537277,27236,8342636,2453,4728024,482,466617,3979,509109,0.06334,4707,6605944,0.821872,4461,7115053,0.885212,8037679
4,2021-09-29,28401,13565678,25595,8368231,2375,4730399,431,467048,3701,508801,0.063302,4454,6610398,0.822426,4146,7119199,0.885728,8037679
4,2021-09-30,28922,13594600,26232,8394463,2258,4732657,432,467480,3546,508340,0.063245,4451,6614849,0.82298,3990,7123189,0.886225,8037679
4,2021-10-01,31891,13626491,28734,8423197,2757,4735414,400,467880,4037,507531,0.063144,5259,6620108,0.823634,4450,7127639,0.886778,8037679
4,2021-10-02,13605,13640096,12149,8435346,1272,4736686,184,468064,2095,506931,0.063069,2882,6622990,0.823993,2282,7129921,0.887062,8037679
4,2021-10-03,4475,13644571,3822,8439168,579,4737265,74,468138,761,506835,0.063057,933,6623923,0.824109,837,7130758,0.887166,8037679
